practised	practised
follow	follow
bricks	brick - s
annually	annual - ly
canada	canada
emmanuel	emmanuel
expert	expert
foolery	f - oolery
relation	relat - ion
formal	formal
answered	answer - ed
roved	rov - ed
directories	direct - or - ies
chances	chance - s
of	of
cruelly	cruel - ly
detection	detect - ion
strokes	stroke - s
treasurer	treasurer
typography	typography
yourself	yourself
aprons	apron - s
khaki	khaki
backward	backward
frightening	frighten - ing
wounds	wound - s
intimately	intimate - ly
obscure	obscure
thighs	thigh - s
reasoning	reason - ing
nobleman	nobleman
opponent	opponent
manipulate	manipulate
resemble	re - sembl - e
ambivalent	ambivalent
orgiastic	orgiastic
tapped	tapp - ed
interim	in - terim
lions	lions
highly-trained	highly-trained
riotous	riotous
goatee	goat - e - e
familiar	familiar
habit	habit
leaky	leak - y
dutifully	dutifully
mentioned	mention - ed
senile	senile
floated	float - ed
pulling	pull - ing
gaze	gaz - e
perpetually	perpetual - ly
pockets	pocket - s
un	un
jews	jews
appearance	appearance
forced	forc - ed
horde	horde
objection	object - ion
surprisingly	s - urpris - ing - ly
limit	limit
recdep	recdep
health	health
oldthinkers	oldthink - er - s
record	record
pick-axe	pick-axe
dumb	dumb
splayed	s - play - ed
striking	strik - ing
tenth	tenth
sunshine	s - un - shin - e
cloudy	cloud - y
disguised	dis - guise - d
plausibly	plausibl - y
regions	regions
thoroughness	thorough - ness
painless	p - ainles - s
bung	bung
lessened	lessened
relics	re - lic - s
attraction	attract - ion
dates	dat - e - s
road	road
bakeries	bakeries
cardboard	cardboard
urge	urge
lumped	lump - ed
underneath	underneath
allowed	allow - ed
guardian	guardian
gather	gather
memoranda	memoranda
19.12.83	19.12.83
pores	pores
scarcity	scarcity
suddenness	sudden - ness
pitiful	p - itiful
roughly	rough - ly
subordinate	s - ubordinate
took	took
equality	equal - ity
straightening	straighten - ing
attain	attain
diapers	diapers
sleep	sleep
penholder	p - en - holder
doleful	dole - ful
doublepluscold	double - pluscold
quackquack-quacking	quackquack-quack - ing
cured	cur - ed
cleaned	clean - ed
rapid	rapid
educate	educat - e
ahead	a - head
close	clos - e
emerge	emerge
revolutionary	revolutionary
forgot	forgot
amount	amount
etymologically	etymological - ly
instinct	instinct
dreaming	dream - ing
masses	mass - es
plaque	plaque
powerless	power - less
reptiles	reptiles
lunatic	lunatic
poems	poem - s
forgeries	forgeries
pierce	pierc - e
injured	injur - ed
scepticism	scepticism
securing	secur - ing
truth	truth
leg-irons	leg-irons
having	having
willow-herb	willow-herb
catching	catch - ing
feats	f - eat - s
plenty	plenty
vindictiveness	vindictive - ness
quarter	quart - er
outwit	outwit
youths	youth - s
understand	understand
formerly	form - er - ly
straightened	straighten - ed
grace	grace
drivelling	drivelling
help	help
rapped	rapped
secured	secur - ed
cow	c - ow
hard-working	hard-working
mats	mat - s
dog-eared	dog-ear - ed
blank	blank
shoelaces	shoelace - s
voluntary	voluntary
executions	execut - ion - s
booty	boot - y
extinct	extinct
bang	b - ang
blade	blade
recognizable	recogniz - able
stockings	stock - ing - s
book	book
equilibrium	equilibrium
cautiously	cautious - ly
thass	thas - s
ironical	ironical
soul	s - oul
trains	train - s
blows	b - low - s
beer	b - eer
enthusiasms	enthusiasm - s
loaded	loaded
squeals	squeal - s
'im	'im
waste	wast - e
flourish	flourish
way	way
froze	froze
swear	s - wear
sigh	sigh
slogging	s - logg - ing
halted	halt - ed
million	million
start	start
hunched	hunched
rigidly	rigid - ly
snooping	snoop - ing
tugging	tugging
fitting	fitt - ing
depicted	depicted
equipment	equipment
clawing	claw - ing
cutting	cutt - ing
certainty	certainty
mantelpiece	mantelpiece
reproach	re - p - roach
command	command
improvement	improve - ment
loopholes	loopholes
sixty-three	s - ixty-three
abstruse	abstruse
seat	s - eat
grandfather	grand - father
persecution	persecution
faster	fast - er
came	came
battered	batter - ed
excitedly	excit - ed - ly
violets	violets
climbed	c - limb - ed
customers	customer - s
survivors	s - urvivor - s
publicly	public - ly
version	version
camera	camera
poet	p - oet
symbol	symbol
totally	total - ly
survived	survive - d
construction	construction
sentences	sentence - s
times	time - s
proximity	proximity
eagerness	eager - ness
preaches	p - re - ache - s
vegetables	vegetable - s
prediction	predict - ion
commune	commun - e
thickly-populated	thickly-populat - ed
participle	participle
grudge	grudge
sizeable	sizeable
distinction	distinct - ion
extraction	extract - ion
burner	burn - er
martin	martin
rivalry	rival - ry
gaps	gaps
slavery	slavery
registers	register - s
shrewish	shrewish
forehead	forehead
exhibit	exhibit
flowers	flower - s
pure	pure
remonstrances	remonstrance - s
strolling	stroll - ing
booming	boom - ing
regained	re - gain - ed
unrepented	un - re - pent - ed
ghostly	ghost - ly
behalf	be - half
burial	burial
preceded	preced - ed
grain	grain
bones	b - one - s
vertebrae	vertebrae
stroke	stroke
rainwatery	rainwater - y
baal	baal
fornication	fornication
childish	child - ish
horse	horse
loveful	loveful
officiousness	officiousnes - s
half-certainty	half- - certainty
turning-point	turning-point
make	make
rebellions	rebellion - s
various	variou - s
protest	protest
label	label
you	you
divide	divid - e
formidable	formidable
reappearing	re - appear - ing
bargaining	bargaining
keyhole	keyhole
sadly	sad - ly
father	father
guess	guess
engineers	engine - er - s
described	describ - ed
dishes	dishes
edified	edifi - ed
matched	match - ed
dentures	denture - s
faintly	faint - ly
industry	industry
thanks	thank - s
hedonistic	hedonistic
o'brien	o'brien
soundlessly	soundless - ly
achieve	achiev - e
pillar	pillar
too-popular	too-popular
ambiguities	ambiguities
bestrode	bestrode
seventeenth	seventeen - th
universe	un - ivers - e
streams	stream - s
wild	wild
invasion	invasion
sheep-like	sheep-like
shortest	short - est
starving	starv - ing
1984	1984
beggars	beggar - s
begun	be - gun
lawyers	lawyers
versions	version - s
bailey	bailey
jointed	joint - ed
ability	ability
skull-like	skull-like
creating	creat - ing
ful	ful
logic	logic
mistake	mistake
rectangular	re - ctangular
days	day - s
routine	routine
stall	s - tall
alliance	alliance
central	central
bill	bill
accord	accord
corrupt	corrupt
cobblestone	cobblestone
nations	nation - s
sheep	s - heep
stupendous	stupendous
furrows	furrows
potatoes	potato - e - s
irreconcilable	irreconcilabl - e
bitter	bitter
freckles	freckle - s
childbearing	childbearing
flooded	flood - ed
camaraderie	camaraderie
commoner	common - er
physique	p - hysique
mates	mat - e - s
vanished	vanish - ed
flicks	flicks
church	church
brightened	b - rightened
references	reference - s
weapons	weapon - s
mare-like	mare-like
plays	play - s
surface	s - urface
oblong	oblong
everflowing	everflow - ing
self	self
necessities	necessit - ies
vividly	vivid - ly
intact	in - tact
rewrite	re - write
astronomical	astronomical
pillow	pillow
superlatively	superlatively
anyway	anyway
firm	firm
1900	1900
awakening	awaken - ing
folded-up	folded-up
grades	grades
retch	retch
details	detail - s
worst	worst
than	than
arising	aris - ing
bomb	bomb
line	line
devise	devise
atoms	atoms
minipax	minipax
motioned	motion - ed
nowadays	nowadays
agreed	agree - d
persuade	persuad - e
charm	c - harm
pubs	pub - s
degradation	degradation
proletariat	p - roletariat
denied	deni - ed
discredited	discredit - ed
intelligible	intelligible
ox	ox
gleam	gleam
hanged	hang - ed
adherence	adherence
deprived	depriv - ed
exerts	exert - s
ice	ice
extinction	extinct - ion
jeering	jeering
instinctively	instinct - ive - ly
faked	faked
prisoners	prisoner - s
automatically	automatic - ally
table-tennis	table-tenni - s
boomed	boom - ed
pretended	pretend - ed
doubted	doubt - ed
powers	power - s
self-propelled	self-propelled
thought-criminal	thought-criminal
destroying	destroy - ing
jet	jet
convinced	convinc - ed
lips	lip - s
hob	hob
mellowed	mellow - ed
recently	re - cent - ly
tinkling	tinkl - ing
trueful	true - ful
usually	usual - ly
desert	desert
flunkies	flunkies
minerals	mineral - s
sensations	sensation - s
visualizing	visualiz - ing
schools	school - s
300	300
excellent	excellent
spying	spying
waddling	waddl - ing
without	without
ranks	rank - s
galloped	galloped
nor	n - or
wilder	wild - er
unbellyfeel	un - bellyfeel
obligation	obligation
bribery	bribery
grave	grav - e
perceived	perceiv - ed
filled	fill - ed
frigid	f - rigid
declaration	declar - at - ion
windy	windy
!	!
coal	c - oal
clue	clue
married	married
sniffed	sniff - ed
helicopters	helicopter - s
socialism	socialism
jefferson	jefferson
can't	can't
handsome	handsom - e
bucket	bucket
concrete	concrete
contact	contact
dislocations	dislocation - s
suggestion	suggest - ion
pendulum	pendulum
transit	transit
four-horse	four-horse
battleship	battleship
reversal	revers - al
spreading	s - p - read - ing
loved	love - d
twenty-seven	twenty-seven
screwdriver	s - crewdriver
85	85
comradeship	comradeship
satisfy	satisfy
supply	s - uppl - y
dropping	dropp - ing
self-righteousness	self- - righteousness
grouping	group - ing
acuteness	acute - ness
beforehand	beforehand
beatings	beat - ing - s
favourite	favourit - e
palace	palace
everlasting	everlast - ing
fleeing	flee - ing
food	food
kicks	kick - s
acquiring	acquir - ing
quarto-sized	quarto-siz - ed
directing	direct - ing
reassured	reassur - ed
loudness	loudness
slum	slum
actually	actual - ly
surveillance	surveillance
faking	f - a - king
third	third
discontented	dis - content - ed
disobey	dis - obey
technology	technology
intent	intent
preserve	p - re - serve
concealed	conceal - ed
status	status
army	arm - y
boring	boring
learn	learn
secret	secret
sudden	sudden
'isself	'isself
surplus	surplus
fair-haired	fair-hair - ed
fell	fell
yelling	yell - ing
casting	cast - ing
trade-union	trade-union
troubled	troubl - ed
illegitimately	illegitimately
1970	1970
nonexistence	nonexistence
syntax	syntax
flitting	f - litt - ing
official	official
successive	success - ive
sulphuric	sulphuric
'eals	'eals
pale-coloured	pale-coloured
equipped	equipp - ed
affix	affix
significance	s - ignificance
native	native
mug	mug
thereafter	thereafter
baths	bath - s
pocket	pocket
possibly	possibly
two	two
abyss	a - by - s - s
characteristic	characteristic
incriminate	incriminat - e
read	read
played	play - ed
fitfully	f - itfully
pleasure	pleasure
proceeding	proceed - ing
sleepy	sleep - y
logistics	logistics
humiliated	humiliat - ed
minority	minority
snapping	snapping
all-round	all- - round
twos	two - s
endless	endless
shrink	shrink
walking	walk - ing
upheavals	upheavals
drawing	draw - ing
removed	re - move - d
russia	russia
indistinctly	in - distinct - ly
expended	expend - ed
requires	require - s
bargainings	bargaining - s
concepts	concept - s
groin	groin
definitely	definite - ly
stuck	s - tuck
liquid	liquid
twitch	twitch
selfabasement	selfabasement
known	known
venereal	venereal
ally	all - y
sharp-pointed	sharp-pointe - d
blind	blind
chiefs	chief - s
blond	blond
essentially	essential - ly
explore	explore
breathe	breath - e
train	train
burst	burst
arst	arst
wine	win - e
addressed	addres - s - ed
concerned	concern - ed
roamed	roamed
narrowed	narrow - ed
delicate	delicate
records	record - s
monotonous	monotonous
shudder	shudder
december	december
involuntary	in - voluntary
plead	p - lead
sacrificed	sacrific - ed
slit	s - lit
gratitude	gratitude
unprocurable	un - procur - able
arrowslits	arrowslit - s
whitequilted	whitequilted
snakes	s - nakes
spanking	spank - ing
brown-coloured	brown-colour - ed
restricted	re - strict - ed
debased	debas - ed
airfields	airfield - s
fluted	f - lut - ed
especial	especial
breasts	breast - s
tiredness	tired - ness
sides	side - s
'as	'a - s
bugs	b - ugs
drums	drum - s
fastener	fasten - er
gleamed	gleam - ed
gin	gin
helplessness	helpless - ness
pursued	pursu - ed
blocking	block - ing
lap	lap
meditated	meditat - ed
objects	object - s
astonishment	astonish - ment
brazzaville	brazzavill - e
precautions	p - re - caution - s
navigate	navigate
pannikins	pannikin - s
study	study
preterite	p - reterite
regular	regular
avert	avert
instead	in - stead
'eart	'eart
fourth	four - th
necessitated	necessit - at - ed
unscrew	un - screw
mobile	mobile
low-ceilinged	low-ceilinged
glanced	glanc - ed
rule	rule
face	face
missing	miss - ing
shops	s - hop - s
was	was
dice-box	dice-box
perfected	perfect - ed
awakened	awaken - ed
rabbit	rabbit
robin	robin
fixture	fixture
gracelessness	grace - less - ness
is	is
repudiate	repudiate
intrigued	intrigue - d
summer	summer
attracting	attract - ing
frail	f - rail
remnants	remnants
saplings	sapling - s
moustaches	moustache - s
secretary	secret - ary
tracing	trac - ing
canvas	canvas
normal	normal
greedy	greedy
curious	curiou - s
crushing	crush - ing
belch	belch
subsidiary	subsidiary
rendered	render - ed
disgraced	disgraced
curving	curv - ing
distaste	dis - taste
if	if
munition	munition
belongings	belong - ing - s
foul	f - oul
hang	hang
standard	standard
faroe	faroe
closer	clos - er
floodlit	floodlit
mails	mails
softly	soft - ly
unbearable	un - bearable
windows	window - s
singing	sing - ing
frightened	frighten - ed
specifically	specific - ally
smoke	smok - e
comparison	comparison
absolutely	absolute - ly
600	600
impossibility	im - possibilit - y
learning	learn - ing
clarified	clarified
ball	b - all
keyholes	keyhole - s
outlines	outline - s
plans	plan - s
shiny	shin - y
amateurishly	amateurishly
spirally	spiral - ly
contorted	contort - ed
dullbrown	dullbrown
quietly	quiet - ly
subtilized	subtilized
disappointment	disappoint - ment
sentence	sentence
superior	superior
born	born
dust	dust
arrayed	array - ed
dictating	dictat - ing
applied	applied
effect	effect
adapted	adapt - ed
aeroplane	aeroplane
justify	justify
aggressions	aggressions
tentatively	tentativ - e - ly
protuberant	protuberant
temporarily	temporari - ly
acrorss	acrorss
brought	br - ought
doves	dove - s
evils	evil - s
odds	odd - s
breed	breed
almost	al - most
sealed	sealed
subject	subject
word	word
sat	s - at
appearing	appear - ing
stomach	stomach
decision	decision
deathly	death - ly
notice	notic - e
disguise	dis - guise
uttered	utter - ed
somehow	somehow
easier	easier
cup	cup
throughout	throughout
virtue	virtue
nakedness	naked - ness
wrench	wrench
hockey-sticks	hockey-stick - s
fingernails	fingernails
crowding	crowd - ing
dozens	dozen - s
working-out	working-out
exposed	exposed
sank	sank
calculating	calculat - ing
form	form
find	find
support	support
hum	hum
jabbed	jabbed
cinders	cinders
mere	mere
parasites	parasites
lifes	life - s
fantasy	fantasy
half-remembered	half- - re - member - ed
bloody	blood - y
stuff	stuff
ounces	ounce - s
refuse	refus - e
fruit	fruit
these	the - s - e
shelf	s - helf
unity	unit - y
rhymes	rhyme - s
science	science
garbled	garbled
rising	rising
avaricious	a - varicious
thump	thump
whatever	whatever
improvised	improvis - ed
unclean	un - clean
saved	sav - ed
compartments	compartments
iron-shod	iron-shod
buzz	buzz
misquotations	misquotations
spells	s - p - ell - s
irrevocable	irrevocable
supposed	suppos - ed
incurred	incurr - ed
jerk	jerk
biological	biological
horrors	horror - s
killing	kill - ing
proceeded	proceed - ed
rabbit-bitten	rabbit-bitten
wreckage	wreckage
yard	yard
authorized	author - ized
canteen	canteen
destroy	destroy
competing	compet - ing
prizefighter	prizefighter
residue	residue
unalterable	un - alterable
to-and-fro	to-and-fro
away	a - way
nostalgic	nostalgic
bigoted	bigoted
probable	probabl - e
flash	flash
fours	four - s
destroys	destroy - s
consecutive	consecutive
judging	judg - ing
mechanics	mechanics
transferred	transferr - ed
washed	wash - ed
civilization	civilization
incautiously	in - cautious - ly
pepper	pepper
socialist	socialist
character	character
polishing	polish - ing
diamond-shaped	diamond-shap - ed
cut	c - ut
impressive	impress - ive
link	link
tasks	task - s
unwearying	un - wear - y - ing
concerns	concern - s
whether	whether
brisk	b - risk
fired	fir - ed
'alf	'alf
satisfying	satisfy - ing
internal	internal
attaching	attach - ing
rackety	racket - y
gelatinous	gelatinous
theme-song	theme-song
paying	p - aying
wished	wished
concretely	concrete - ly
suffered	s - uffer - ed
jollying	jolly - ing
effectively	effect - ive - ly
eternity	etern - ity
daughters	daughter - s
reek	reek
working-hours	working-hours
irresolutely	irresolute - ly
loaf	loaf
fidget	fidget
passed	pass - ed
events	event - s
flashing	flash - ing
philosophy	philosoph - y
morals	moral - s
guide	guide
protruded	protruded
crowded	crowd - ed
haunt	haunt
drag	drag
appeal	appeal
lunacy	lunacy
minor	minor
graduating	graduat - ing
conviction	convict - ion
transcription	transcription
worrying	worry - ing
writhed	writh - ed
owners	own - er - s
sacking	sack - ing
estimated	estimate - d
portraits	portrait - s
irrepressible	irrepressible
novel	novel
all-out	all-out
reverie	reverie
justice	justice
nazis	nazi - s
beggar	beggar
overcame	overcame
deciding	decid - ing
technique	technique
tiger	tig - er
mrs	mr - s
break	break
tension	tens - ion
clamped	c - lamp - ed
memorizing	memoriz - ing
circumstances	circumstances
consorting	con - sort - ing
chapter	chapter
monstrous	monstrou - s
permanently	p - ermanent - ly
conveyed	convey - ed
retention	re - tention
satisfactorily	satisfactorily
forge	forge
glaring	glaring
anger	ang - er
comradely	comrade - ly
massacres	massacr - e - s
eased	ease - d
laboratories	laboratories
backstreet	backstreet
maidens	maiden - s
healing	heal - ing
regarded	regard - ed
rhythmic	rhythmic
,	,
gory	gory
robes	rob - e - s
roman	roman
brassy	bras - s - y
tang	tang
tumbling	tumbl - ing
breakfast	breakfast
ultimate	ultimate
swum	swum
lay	lay
velvet	velvet
watching	watch - ing
spoons	spoon - s
winters	winter - s
comforting	comfort - ing
map	map
ill-lit	ill-lit
outwards	outward - s
exchanged	exchange - d
owned	own - ed
pronounced	pronounce - d
sneaked	sneak - ed
boiled-cabbage	boiled-cabbage
orgasm	orgasm
pack	pack
rods	rod - s
explanation	explanation
eurasia	eurasia
arrested	arrest - ed
assisted	a - ssisted
refers	re - fer - s
sucked	sucked
didactically	didactically
blasphemy	blasphemy
wriggled	wriggle - d
surname	s - urname
reproduce	re - produc - e
wouldn't	wouldn't
me	me
thank	thank
miss	miss
pint	pint
foolproof	foolproof
revived	revived
convince	convinc - e
grim	grim
realizing	realiz - ing
resting	re - s - ting
shambled	shambl - ed
deny	deny
vertically	vertical - ly
wilsher	wilsher
complete	complete
staircase	staircase
neighbourhood	neighbourhood
pinch	pinch
front	front
cheering	cheer - ing
green	green
hardening	harden - ing
sixth	s - ixth
unmistakable	unmistakabl - e
witty	witty
essay	essay
gazed	gaz - ed
glazed	glazed
affairs	affair - s
europe	europe
hearts	heart - s
purged	p - urge - d
resemblance	re - sembl - ance
short	short
alighted	a - light - ed
uneven	un - even
no	no
quiet	quiet
great	great
zealot	zealot
self-hypnosis	self- - hypnosis
sending	s - ending
dislike	dis - like
prompted	prompt - ed
untruth	un - truth
i._e.	i._e.
six	six
campaigns	campaign - s
doubleplusgood	double - plusgood
bleating	bleat - ing
pouches	pouch - e - s
established	establish - ed
generation	generation
etiolated	etiolated
cage	c - age
leaping	leap - ing
consumption	consumption
mankind	mankind
individuals	individual - s
stiffening	stiffen - ing
accused	accus - ed
although	al - though
bit	b - it
grandchildren	grand - children
impossibly	im - possibly
bursting	burst - ing
moods	mood - s
?	?
enlarge	enlarge
eccentricity	eccentricity
envelope	envelop - e
experience	experience
katharine	katharine
sunlight	s - un - light
paddington	paddington
brain	brain
wealth	wealth
recaptured	re - capture - d
african	africa - n
equivocal	equivocal
unconsciously	un - consciou - s - ly
cultural	cultur - al
exceedingly	exceeding - ly
bus-stop	bus-stop
denial	deni - al
curable	curable
changing	c - hang - ing
tracking	track - ing
wanting	want - ing
atmosphere	atmosph - er - e
enjoying	enjoy - ing
complexity	complex - ity
seduced	seduced
sheaves	s - heave - s
quickly	quick - ly
advocating	advocat - ing
cry	cry
moisture	moisture
vehicle	vehicle
retreated	re - treat - ed
bliss	bliss
laid	laid
any	an - y
enrolled	enroll - ed
either	either
fuzzy	fuzzy
cadging	cadg - ing
range	rang - e
settled	settle - d
climbing	c - limb - ing
documentary	document - ary
fabrication	fabrication
deaths	death - s
typical	typical
midday	midday
cartoons	cartoons
in-laws	in-laws
neck	neck
sliding	slid - ing
creaking	creak - ing
prize-fighter	prize-fighter
assent	a - s - sent
clipped	c - lipped
nails	nails
tubes	tube - s
blazing	blaz - ing
cumbersome	c - umbersome
spanner	spanner
closesmelling	closesmelling
triangular	triangular
imagined	imagin - ed
knocked	knock - ed
shaken	shak - en
dreamed	dream - ed
exactly	exact - ly
selfdenial	selfdenial
reserve	re - serve
sites	s - it - e - s
detected	detect - ed
well-appointed	well-appointed
west	west
beget	be - get
author	author
currents	current - s
feeble	feebl - e
pulp	p - ulp
despair	despair
rationalism	rationalism
turns	turn - s
uproar	uproar
guns	guns
half-page	half-pag - e
readjustment	re - adjust - ment
drug-taking	drug-taking
bothering	bother - ing
overcoat	overcoat
vitality	vital - ity
leaflets	leaflet - s
rent	rent
syringe	s - yringe
whisper	whisper
birds	bird - s
dimmed	dimm - ed
perfection	perfect - ion
institute	institute
compiling	compil - ing
proletarian	proletarian
refs	refs
meritorious	meritoriou - s
tuft	tuft
crush	crush
vaguely	vague - ly
themselves	themselves
bright	b - right
plusgood	plusgood
windowless	window - less
subtlest	subtl - est
double	doubl - e
life-and-death	life-and-death
rational	ration - al
disposed	dispos - ed
chuckling	chuckling
learnt	learnt
simplest	simpl - est
stupefied	stupefied
earlier	earli - er
per	p - er
toy	to - y
doctrine	doctrine
almost-deserted	almost-desert - ed
eleven	eleven
imagining	imagin - ing
pad	pad
stowed	s - tow - ed
remoter	remot - er
structure	s - tructure
uselessness	useless - ness
tentative	tentativ - e
abstainer	abstainer
grabbed	grabb - ed
pocketed	pocket - ed
someone	someone
plexus	plexus
20	20
flurry	f - lurry
shot	s - hot
undermost	undermost
candle-lit	candle-lit
ink-pencil	in - k-pencil
swimming	swimm - ing
sturdy	sturdy
frequent	frequent
erroneous	erroneous
vague	vague
pre-industrial	pre-industrial
reporting	report - ing
sharpness	sharp - ness
conquerable	conquerable
instituted	institute - d
looped	loop - ed
selfishness	selfish - ness
japanese	japanese
please	p - lease
massed	mass - ed
nip	nip
obedience	obedience
martyrdoms	martyrdoms
linking-together	linking-together
manufacture	manufacture
locket	locket
electrically	electric - ally
swung	swung
dual	dual
condemned	condemn - ed
hypnosis	hypnosis
instance	instance
released	re - lease - d
horizontally	horizontal - ly
evil-tasting	evil-tast - ing
committing	committ - ing
illiterate	illiterat - e
salt	salt
altercation	altercation
smashed	smash - ed
societies	s - ocieties
cold	cold
half-hearted	half-hearted
magnifying	magnifying
protected	protect - ed
flagged	f - lagged
nought	n - ought
sleeping	sleep - ing
middle-aged	middle-aged
interstellar	interstellar
stands	stand - s
hearing	hear - ing
concept	concept
propaganda	p - ropaganda
excluding	exclud - ing
glancing	glanc - ing
good	good
get	get
julius	julius
keenness	keennes - s
barbarities	barbaritie - s
negative	negative
inspiration	inspirat - ion
noticed	notic - ed
larynx	larynx
rehashing	rehashing
gallery	gallery
rowdy	row - d - y
generated	generate - d
shook	shook
3rd	3rd
suicide	suicide
drew	drew
tepid	tepid
twice	twice
basis	basi - s
enunciating	enunciat - ing
urbane	urbane
victory	victor - y
chance	chance
door-knob	door-knob
each	each
flame	flame
printing	print - ing
chalked	chalk - ed
helpless	helpless
knotted	knott - ed
explain	explain
extreme	extreme
underfoot	underfoot
flit	flit
lonely	lonely
uncommanded	un - command - ed
parasitical	parasitical
buying	buying
dissipated	dissipated
shoved	shov - ed
emotional	emotion - al
100	100
encouragement	encourag - e - ment
good-thinking	good-thinking
plottings	plottings
uninterested	un - interest - ed
ankle	ankle
incongruous	incongruou - s
pride	pride
optimism	optimism
planned	plann - ed
plug	plug
lights	light - s
origins	origin - s
alluring	al - luring
sound-tracks	sound-track - s
meeting	meet - ing
watch	watch
opportunity	opportunity
agricultural	agricultural
sledge-hammer	sledge-hammer
brush-down	brush-down
thousand	thousand
flinched	flinched
wooden-faced	wooden-fac - ed
largest	larg - est
flowed	flow - ed
nausea	nausea
mansions	mansions
come	come
'	'
thrashing	thrash - ing
above	above
weeks	week - s
tragedy	tragedy
utopianism	utopianism
enjoyment	enjoy - ment
title	title
rape	rape
ulcer	ulcer
tastes	taste - s
leaf	leaf
invent	invent
politically	political - ly
controls	control - s
refrain	refrain
realization	realization
mercy	mercy
tyrannies	tyranni - es
champagne	champagne
back	back
oddly	odd - ly
registered	register - ed
prove	prov - e
hurt	hurt
chess	c - he - s - s
gravity	grav - ity
inheritors	inherit - or - s
kneeling	kneel - ing
lugged	lugged
north	north
attention	attention
instant	instant
announced	announce - d
reports	report - s
smear	smear
target	target
thrush	thrush
turnip	turnip
cups	cup - s
indefinable	in - definable
persisted	persist - ed
musical-box	musical-box
card	card
subtly	subtl - y
neighbour	neighbour
nipped	nipp - ed
notice-board	notice-board
pretending	pretend - ing
prizes	prizes
1965	1965
exceptions	exception - s
risks	risk - s
sickening	sicken - ing
junk-shop	junk-shop
neighbours	neighbour - s
supplementary	supplement - ary
cities	cities
treatment	treat - ment
thrill	thrill
high-ceilinged	high-ceil - ing - ed
wander	wander
chiefly	chief - ly
madness	madness
exploits	exploit - s
rinsed	rinsed
inert	in - ert
layers	lay - er - s
geared	geared
inflict	inflict
operation	operat - ion
whips	whips
appointed	a - p - point - ed
land	land
keyword	keyword
makes	make - s
white-aproned	white-aproned
consumable	consum - able
fix	fix
bureaucrats	bureaucrat - s
barked	bark - ed
entire	entire
extraordinary	extra - ordinary
breeding	breed - ing
barbarous	barbarous
patterns	pattern - s
source	source
startling	startl - ing
bunks	bunk - s
worship	worship
personality	personality
synthesize	synthesize
corners	corn - er - s
goodest	good - est
hopeless	hopeles - s
nearest	near - est
everlastingly	everlast - ing - ly
unavoidable	un - avoid - able
mute	mute
religious	re - ligiou - s
resist	resist
stone	s - tone
substitute	substitut - e
demolished	demolish - ed
burly	b - urly
bars	bar - s
kent	kent
intellectually	intellectual - ly
upright	upright
volunteers	volunteers
imaginary	imagin - ary
hikes	hike - s
message	message
slithering	slither - ing
immediately	immediate - ly
since	since
grew	grew
instruments	instrument - s
bosom	bosom
re-adjusted	re- - adjust - ed
mechanical	mechanical
nose	nose
except	except
seems	seem - s
sticking	s - tick - ing
clever	clever
cringe	c - ring - e
concentrate	concentrat - e
fed	f - ed
slapped	s - lapped
b.b.	b.b.
demanding	demand - ing
hurried	hurried
histories	histories
strangers	strangers
whispers	whisper - s
satisfactory	satisfactory
presupposed	p - re - suppos - ed
reflexes	re - flexes
entries	entries
thereby	thereb - y
undeclared	un - declar - ed
brute	brute
squeezing	squeez - ing
veins	veins
bulletin	bulletin
merely	mere - ly
demographic	demographic
calling	call - ing
inflected	inflect - ed
tunefully	tuneful - ly
cracked	c - racked
occurs	occur - s
spoiled	spoil - ed
momentous	momentou - s
strike	strik - e
defined	defin - ed
already	al - read - y
sandy	sandy
cheekbone	cheekbone
harder	hard - er
salary	salary
bondage	bondag - e
smartly	s - mart - ly
leaders	lead - er - s
saw	saw
guessed	guess - ed
bottling	bottling
shallowness	shallow - ness
sore	sore
comforts	comfort - s
oxes	ox - e - s
uncalled	un - call - ed
needle	needle
grassy	grass - y
hide	hide
less	less
f	f
sugar	sugar
violations	violations
capitalism	capital - ism
deep-bosomed	deep-bosomed
metallic	metallic
breath	breath
generally	general - ly
tamper	tamper
doubly	doubl - y
obtain	obtain
belong	belong
servile	s - ervile
sounds	sound - s
itself	itself
tickled	tickl - ed
fingers	finger - s
pantry	pantry
went	went
worshipped	worshipp - ed
tufts	tuft - s
creased	creas - ed
charge	charge
claimed	claim - ed
attached	attach - ed
sinecures	sinecure - s
farthings	farthing - s
stretch	stretch
switch	switch
knelt	knelt
rutherford	rutherford
scarlet	s - carlet
humorous	h - umorous
foot	foot
spread	s - p - read
:	:
accordingly	accord - ing - ly
packets	packet - s
thoroughfare	thoroughfare
waging	waging
alignment	al - ignment
referring	re - ferr - ing
aimed	aim - ed
trucks	truck - s
how	how
limply	limply
horse-ploughs	horse-ploughs
pact	p - act
leadership	leadership
lice	lic - e
unwise	un - wise
biologist	biologist
inconvenient	in - convenient
peculiarities	peculiar - ities
pale-grey	pale-grey
transformed	transform - ed
columns	column - s
hush	hush
being	being
spared	spared
thoughts	thought - s
interesting	interest - ing
pedant	p - edant
cheese	cheese
lifeless	lifeles - s
filthy-tasting	filthy-tast - ing
lifetime	lifetim - e
lusty	lust - y
martin's-in-the-fields	martin's-in-the-fields
specialist	specialist
stay	stay
nerved	nerve - d
palpable	palpable
palm	palm
finally	final - ly
preparation	preparation
ticking	tick - ing
mending	mend - ing
swam	swam
julia	julia
dimly	dim - ly
ripe	ripe
fairly	f - air - ly
few	few
stationary	station - ary
open	open
trees	tree - s
tennis	tenni - s
dabs	dabs
distance	distance
received	receiv - ed
[	[
escaped	escape - d
half-litres	half-litre - s
bar	bar
longed	long - ed
obsolete	obsolete
termination	terminat - ion
enchanter	en - chant - er
horribly	horribly
privation	privation
awye	awye
ambitious	ambitious
erasure	erasure
newly-created	newly-created
bleeding	bleed - ing
occupying	occupy - ing
approaching	approach - ing
disappointed	disappoint - ed
bunting	b - un - ting
balance	balanc - e
flakes	flake - s
inconsequently	inconsequent - ly
unreasonable	un - reason - able
'is	'i - s
minilovely	minilovely
expressionless	express - ion - less
categorical	categorical
station	station
slips	s - lip - s
gun	gun
dark-haired	dark-hair - ed
1930	1930
catalogue	catalogue
technical	technical
malabar	malabar
mischievous	mischievous
injustice	in - justice
roofs	roof - s
drove	drov - e
misdemeanour	mis - demeanour
quarry	quarry
salutation	s - al - utation
comb	comb
led	led
smuggle	smuggle
rise	rise
struck	s - truck
centuries	centur - ies
sect	sect
following	follow - ing
stratosphere	stratosphere
lacks	lack - s
swelled	s - well - ed
unpersons	un - person - s
claptrap	claptrap
sweetness	sweet - ness
shuffled	shuffl - ed
grimmer	grimm - er
wash-basin	wash-basin
truthful	truthful
sound	sound
ecstasy	ecstasy
realizable	realiz - able
fender	fender
dwellings	dwellings
c	c
er	er
ruminant	ruminant
fragment	fragment
trickled	trickl - ed
accomplishes	accomplish - es
consequences	consequences
gent	gent
gramophone	gramophone
eliminating	eliminat - ing
prodigious	p - rodigious
gardening	garden - ing
earthquakes	earthquake - s
captain	captain
impulses	impulse - s
actions	action - s
oligarchical	oligarchical
polits	polit - s
fill	fill
sub-human	sub- - human
adulation	adulation
editions	edition - s
succeeded	succeed - ed
internationalism	international - ism
illusion	illusion
rights	right - s
fencing	fencing
addition	addition
kong	kong
lock-up	lock-up
blocks	block - s
institution	institution
entangling	entangl - ing
impudence	impudence
downwards	downwards
governs	govern - s
contralto	contralto
extra	extra
stallkeeper	stallkeeper
communications	communicat - ion - s
directly	direct - ly
south	s - outh
sunk	s - unk
splitting	s - p - litt - ing
thin	thin
using	using
shreds	shreds
disconcerting	disconcerting
this	this
destroyed	destroy - ed
camp	camp
according	accord - ing
tremendous	tremendous
fatuous	fatuou - s
greatly	great - ly
passing	pass - ing
wrinkles	wrinkle - s
poles	pole - s
patted	patted
curiously	curiou - s - ly
exclaimed	exclaimed
scrutiny	scrutiny
do	do
identification	identifi - cation
shapely	shape - ly
gravitates	gravitat - e - s
rubbish-heap	rubbish-heap
draught	draught
quacked	quack - ed
irises	irises
achieved	achiev - ed
dye	dye
generalities	general - ities
boarded	board - ed
contemplate	contemplat - e
unless	un - less
destructive	destructive
himself	himself
discontent	dis - content
noun	noun
consideration	consideration
disturbed	disturbed
inkpot	inkpot
solemnity	solemn - ity
forcing	forc - ing
transformation	transform - at - ion
clenching	clenching
express	express
uninhabited	un - in - habit - ed
disarming	disarming
queen	queen
creak	creak
during	during
military	military
frog-like	frog-like
confess	confess
missed	miss - ed
stimulant	stimulant
engineer	engine - er
tanks	tank - s
used	use - d
comparatively	comparatively
illegal	illegal
kilo	kilo
doubling	doubl - ing
hypnotic	hypnotic
dreadful	dread - ful
conclusion	conclusion
newspeak	new - speak
higher	high - er
treat	treat
rumoured	rumour - ed
comrade	comrade
take	take
nosers-out	nosers-out
amusement	amusement
advisable	advisable
commas	comma - s
variant	variant
practicable	practic - able
intelligence	in - telligence
inaudibly	in - audibl - y
chimney-pots	chimney-pots
whitish	whitish
stink	s - tink
disposes	dispos - e - s
tighter	tight - er
disabled	dis - able - d
discovered	discover - ed
ingenious	in - genious
statutory	statutory
connexion	connexion
cultivation	cultivat - ion
whenever	whenever
declaring	declar - ing
courage	courage
glitter	glitter
sorts	sort - s
been	be - e - n
flames	flame - s
paperweight	paperweight
prevaricate	prevaricate
feared	f - ear - ed
protective	protect - ive
rumpelstiltskin	rumpelstiltskin
draughty	draught - y
slogan	slogan
plastered	plaster - ed
remains	remain - s
stealed	steal - ed
worn-out	worn-out
disproportionately	disproportionately
grizzled	grizzl - ed
wail	wail
too	too
pancras	pancra - s
passage-way	passage-way
momentarily	momentari - ly
sooner	soon - er
slow-moving	slow-moving
acted	act - ed
aeroplanes	aeroplane - s
kilometre	kilometre
pick	pick
secretly	secret - ly
passage	p - assage
resentment	resentment
wind	win - d
devour	devour
protection	protect - ion
stones	s - tone - s
traced	trac - ed
waxwork	waxwork
waste-pipe	waste-pipe
compromising	compromis - ing
beads	beads
foreknowledge	fore - knowledge
resistance	resist - ance
ever	ever
them	them
yp	yp
ought	ought
shoot	shoot
stepping	s - tepp - ing
darkening	darken - ing
gestapo	gestapo
may	may
stanza	stanza
on	on
magnified	magnifie - d
exactitude	exactitude
france	franc - e
compilation	compil - at - ion
permission	permission
raping	raping
imagine	imagin - e
chinless	chinless
coast	coast
easy	easy
organizer	organiz - er
sort	sort
noise-filled	noise-fill - ed
two-storey	two-storey
snap	snap
deaf	deaf
oval	oval
glances	glanc - es
ridiculed	ridiculed
brightly-lit	brightly-lit
exist	exist
arrogant	arrogant
visit	visit
bear	bear
agree	agree
captured	capture - d
relapse	re - lapse
lashes	lash - es
parenthood	parenthood
swallowing	swallow - ing
upwards	upward - s
others	other - s
servant	s - ervant
depth	depth
tool-bag	tool-bag
speck	speck
week	week
denunciation	denunciation
achievement	achievement
playground	p - layground
breadcrumbs	breadcrumbs
rewriting	re - writing
arguments	argument - s
swept	swept
juggling	juggling
vacant	vacant
rested	rest - ed
arrest	arrest
rice	rice
furniture	furniture
couple	c - ouple
inviolate	in - violate
men	me - n
newsflash	new - s - flash
guilty	guilt - y
refusing	refus - ing
swelling	s - well - ing
bloke	bloke
vanquished	vanquish - ed
article	article
bellyfeel	bellyfeel
persons	person - s
besides	beside - s
convert	convert
authoritarian	authoritarian
arranging	arrang - ing
fancied	fanci - ed
thinking	think - ing
memory	memor - y
solve	solve
hope	hop - e
wisdom	wisdom
scrapped	s - c - rapped
tied	tied
credible	credible
spite	spite
mine	mine
contemptible	contemptibl - e
sacrificing	sacrific - ing
grip	grip
experimental	experiment - al
shift	shift
dictates	dictat - e - s
callouses	callouse - s
loathing	loath - ing
hardly	hard - ly
waiting	wait - ing
actual	actual
steep	steep
formations	formation - s
crimes	crime - s
rebel	rebel
nearness	nearness
outlived	out - live - d
serious	serious
subjects	subject - s
muck	muck
exaggeration	exaggerat - ion
crouching	crouching
keep	keep
tripping	tripp - ing
armaments	armaments
calamity	calamity
bearable	bearable
also	also
before	before
grammar	grammar
high-sounding	high-sounding
remark	remark
abolished	abolish - ed
mattress	mattress
difficulties	difficult - ies
underfed	un - derf - ed
coarse	coarse
assimilate	assimilate
disreputability	disreputability
gutters	gutter - s
chivalrous	chivalrous
edged	edge - d
fatigue	fatigue
pen	pen
rebellious	rebellious
boughs	bough - s
mouthpiece	mouthpiece
cleverness	clever - ness
'and	'and
backbone	backbone
ceremony	ceremon - y
together	together
torture	torture
versificator	versificator
wretches	wretch - e - s
abbreviating	abbreviat - ing
habitually	habitual - ly
entered	enter - ed
instructress	in - s - tructress
mugs	mug - s
j.	j.
submitting	submitt - ing
acute	acute
platforms	platform - s
sorrow	sorrow
affair	affair
inevitable	in - evitable
1925	1925
hemmed	hemm - ed
murmured	murmur - ed
tenet	tenet
administrators	administrator - s
dangers	danger - s
acquired	acquir - ed
myth	myth
deliberate	deliberate
hold	hold
intervention	intervention
younger	young - er
crust	c - rust
spontaneously	spontaneous - ly
precisely	p - re - cisely
wear	wear
expression	express - ion
blunt-featured	blunt-featured
overnight	over - night
knights	knight - s
punishment	punish - ment
soon	soon
begged	begged
result	result
unable	un - able
antegetting	antegetting
disappearances	dis - appearance - s
forty-eight	forty-eight
jaw	jaw
episode	episode
figure	figure
found	found
agitprop	agitprop
patched	patch - ed
future	future
ravish	ravish
rushing	rush - ing
sinister	s - in - ist - er
flung	f - lung
razor	razor
stitching	stitch - ing
stick	s - tick
unfortunately	un - fortunately
expected	expect - ed
resembles	re - sembl - e - s
unreservedly	un - reserved - ly
boldness	boldness
branched	branch - ed
unquestionably	un - question - ably
coral	coral
co-ordinated	co-ordinat - ed
knots	knot - s
nineteen-fifties	nineteen-fiftie - s
unknown	un - known
cockney	cockney
collaborated	collaborated
fit	f - it
misdeeds	misdeeds
whirling	whirl - ing
17.3.84	17.3.84
hall	h - all
rustle	rustle
mind	mind
uses	use - s
wiping	wiping
fitness	fitness
precedes	preced - e - s
karl	karl
jerked	jerk - ed
lunge	lung - e
crossing	cross - ing
mixed	mix - ed
adjectives	adjective - s
dabbling	dabbling
surroundings	surround - ing - s
twelve-hour	twelve-hour
screwing	screw - ing
unsupported	un - support - ed
jammed	jamm - ed
perturbed	perturbed
vivid	vivid
intoxication	intoxicat - ion
trivialities	trivial - ities
kissing	kiss - ing
stores	stor - e - s
eager	eager
foregoing	fore - going
lingered	linger - ed
outlined	outline - d
systematized	systematized
establishment	establish - ment
stench	stench
hide-out	hide-out
splits	s - p - lit - s
thoroughly	thorough - ly
many	man - y
nickname	nickname
lethargy	lethargy
noun-verb	noun-verb
bend	b - end
kilograms	kilograms
ah	ah
flaw	f - law
mothers	mother - s
purchased	purchas - ed
patient	patient
thereabouts	thereabouts
coughed	cough - ed
convenience	convenienc - e
menaced	menac - ed
flies	f - lie - s
attitudes	attitude - s
industrially	in - dustrial - ly
punish	punish
tele-programmes	tele-programm - es
2	2
inertia	inertia
most	most
attendants	attendant - s
seldom	s - eldom
establishing	establish - ing
switchover	switchover
dummy	dummy
disintegrate	disintegrate
crushed-looking	crushed-looking
encircle	encircl - e
law	law
magic	magic
arrow	arrow
adept	adept
cobbles	cobble - s
greasy	greas - y
lashed	lash - ed
prepared	prepar - ed
demonstration	demonstrat - ion
rage	rag - e
torn	torn
growing	grow - ing
brazil	brazil
stages	stage - s
vibrate	vibrate
sickly	sick - ly
diverging	diverging
hungrier	hungri - er
interminable	interminable
stillness	stillnes - s
scrubby	s - c - rubb - y
picked	pick - e - d
tree	tree
frosted	frost - ed
synonyms	synonym - s
mad	mad
deposited	deposited
putting	p - utting
tacitly	tacit - ly
flog	flog
done	done
1960	1960
encouragingly	encourag - ing - ly
belly	bell - y
rosewood	rosewood
foresee	foresee
stronger	strong - er
repair	re - pair
vegetation	vegetation
coughing	cough - ing
young	young
deformity	deformity
hesitantly	hesitantl - y
heating	heat - ing
200	200
emanation	emanation
demands	demand - s
mouse	mouse
shored	shor - ed
vehemently	vehement - ly
forgetting	forgett - ing
impedimenta	impedimenta
landed	land - ed
recorded	record - ed
frequently	frequent - ly
forbidden	forbidden
group	group
lane	lane
shaking	shak - ing
storing	stor - ing
thirty-five	thirty-five
window	window
thinness	thinness
drifted	drifted
hypocrite	hypocrite
stars	star - s
duty	duty
drunk	drunk
horseflesh	horseflesh
composed	compos - ed
conspirator	conspirator
tacked	tack - ed
deviations	deviation - s
screen	screen
sharp	sharp
liberalism	liberal - ism
town	tow - n
convoy	convoy
inward	inward
hypocrisy	hypocrisy
never-sleeping	never-sleep - ing
intellect	intellect
god	god
guard	guard
reaching	reach - ing
factory	factor - y
include	includ - e
horns	horn - s
promptly	prompt - ly
fiery	fiery
impair	im - pair
partially	partial - ly
self-willed	self-will - ed
blackbirds	blackbirds
reached	reach - ed
matter	matter
from	from
at	at
merciless	merci - less
magnifies	magnifie - s
dusty	dust - y
clatter	c - latter
servicing	s - ervic - ing
feat	f - eat
believes	believ - e - s
heroes	hero - e - s
gods	god - s
jumped	jump - ed
brutes	brute - s
track	track
gained	gain - ed
album	album
crumpled	crumpled
verbs	verb - s
tones	tone - s
wasn't	wasn't
immorality	im - morality
permanent	p - ermanent
explosives	explosives
a	a
unending	un - ending
process	process
cream-laid	cream-laid
driven	driv - en
lust	lust
sweaty	sweat - y
hundred	hundred
ladder	ladder
revolution	revolution
history	history
pyjamas	pyjamas
supposedly	suppos - ed - ly
kipling	kipl - ing
shapes	shape - s
musing	musing
wheedle	wheedle
cape	cap - e
forgotten-looking	forgotten-look - ing
glassy	glass - y
highly	high - ly
kings	king - s
preceding	preced - ing
steal	steal
perversions	pervers - ion - s
betrayals	betrayal - s
into	into
mistaking	mis - taking
prop	p - rop
oliver	oliver
surgeons	surgeons
substitution	substitut - ion
finding	find - ing
arch	arch
gentleman	gentleman
stored	stor - ed
blokes	bloke - s
perpetual	perpetual
intending	in - tend - ing
muzzle	muzzl - e
stern	stern
fluctuating	fluctuat - ing
plots	p - lot - s
unlikely	un - like - ly
world-power	world-power
ear	ear
wash	wash
oil-cake	oil-cake
squalling	s - quall - ing
forecast	forecast
materials	material - s
paint	paint
job	job
evenly	even - ly
firearms	firearms
towards	toward - s
lingua	lingua
tubby	tubby
chief	chief
persiflage	p - ersiflage
scar	s - car
measurable	measur - able
spectacular	spectacular
coolies	coolies
admitted	admitt - ed
detail	detail
disobeyed	dis - obey - ed
enthusiastic	enthusiastic
hurting	hurt - ing
degree	degree
hunt	hunt
man	man
mediterranean	mediterranean
expropriated	expropriated
fraction	fraction
rallied	ralli - ed
slums	slum - s
insecurity	in - security
intolerable	intolerable
darkness	darkness
string	s - tring
thick	thick
opposed	oppos - ed
gutter	gutter
plundered	plunder - ed
automatic	automatic
parody	parody
satisfaction	satisfaction
sawdust	s - awdust
trouble	troubl - e
playing	play - ing
going	going
98	98
efficient	efficient
alongside	alongside
brackets	b - racket - s
solemn	solemn
widespread	widespread
artificial	artificial
effort	effort
drill	drill
helping	help - ing
toys	to - y - s
undone	un - done
athleticism	athletic - ism
wore	wor - e
which	which
meanwhile	meanwhile
long	long
stump	stump
quarrel	quarrel
smelling	smell - ing
confidence	confidence
vilely	vile - ly
collapsed	collaps - ed
jostled	jostled
wince	winc - e
sports	sport - s
experts	expert - s
gesture	gesture
america	america
difficult	difficult
minitruthful	mini - truthful
abstract	abstract
rubbing	rubb - ing
streets	street - s
vistula	vistula
slots	s - lot - s
sweeps	s - weep - s
impact	im - p - act
degrading	degra - d - ing
ghastly	ghastly
seeks	seek - s
safer	s - afer
commanded	command - ed
mongol	mongol
talents	talent - s
submit	submit
atomic	atomic
easily	easily
muslin	muslin
mystical	mystical
hopes	hop - e - s
breakdown	breakdown
construct	construct
granted	granted
severed	s - ever - ed
involved	involv - ed
pangs	p - ang - s
darting	dart - ing
begins	begin - s
selfdeception	self - deception
why	why
brilliantly	brilliantly
dissolved	dis - solved
incredible	in - credible
ashtaroth	ashtaroth
problem	problem
talk	talk
ripping	ripping
wickedness	wicked - ness
polished	polish - ed
chop	c - hop
long-shaped	long-shaped
summery	summer - y
hallucinations	hallucination - s
strengthened	strength - en - ed
carefully	careful - ly
laying	laying
duck	duck
fixedly	fix - ed - ly
flap	flap
forgiven	forgiven
money	money
raging	raging
truisms	truisms
underclothes	under - clothe - s
gin-scented	gin-scented
successful	success - ful
derivation	deriv - at - ion
unceasingly	un - c - easing - ly
2050	2050
lived	live - d
distributing	distribut - ing
equal	equal
undercharged	under - charge - d
riddle	riddle
rows	row - s
covering	cover - ing
demonstrations	demonstrat - ion - s
hell	hell
admits	admit - s
assumption	assumption
ingsoc	ingsoc
abolish	abolish
rats	rat - s
pornosec	pornosec
leaned	lean - ed
widower	widower
mortal	mortal
remember	remember
cubicle	cubicle
rests	rest - s
formation	formation
seek	seek
denounce	denounc - e
revolutions	revolution - s
production	production
efforts	effort - s
self-contradiction	self- - contradict - ion
vagueness	vague - ness
anxious	anxious
root	root
vaporized	vaporize - d
looting	loot - ing
power-hungry	power-hungry
mask-like	mask-like
scalp	scalp
aside	a - side
subterranean	s - ubterranean
whole	whol - e
protecting	protect - ing
occurring	occurr - ing
fear-ridden	fear-ridden
operate	operat - e
wantonness	wantonness
congo	congo
likeliest	likeli - est
hatred	hatred
lain	lain
learner	learn - er
ourselves	ourselves
accidentally	accident - ally
gambling	gambling
inhabitants	inhabitants
prettier	pretti - er
scale	s - c - ale
gifted	gift - ed
implicating	implicat - ing
zig-zagging	zig-zagg - ing
nippers	nipper - s
snivelling	snivell - ing
murderers	murder - er - s
suicides	suicide - s
split	s - p - lit
dock-worker	dock-worker
electric	electric
clearing	clear - ing
hikers	hikers
final	final
proletarians	proletarian - s
gaping	gaping
stratagem	s - tratagem
tail	tail
translucency	translucency
reasonable	reason - able
descended	descended
altering	alter - ing
films	film - s
half-heartedly	half-hearted - ly
pains	pain - s
bath	bath
deportation	deportation
ignorance	ignor - ance
answers	answer - s
snuffbox	snuffbox
statue	statue
quick	quick
seized	seiz - ed
stone-flagged	s - tone-flagged
muttering	mutter - ing
victor	victor
possible	possible
tillotson	tillotson
twentieth	twentieth
verbal	verb - al
yellowed	yellow - ed
classification	classification
handed	hand - ed
necessarily	necessari - ly
rhyme	rhyme
never-speaking	never-speaking
charred	charred
rear	rear
whereby	whereby
offenders	offend - er - s
undid	un - did
sanctuary	s - anctuary
threatened	threaten - ed
barricades	barricades
switched	switch - ed
names	name - s
nuts	nut - s
chose	chose
dread	dread
oldspeak	oldspeak
boozer	boozer
drops	drop - s
won't	won't
sprung	s - p - rung
manoeuvrings	manoeuvr - ing - s
come-and-go	come-and-go
grief	grief
technician	technician
servant-like	servant-like
elaborately	elaborate - ly
envy	envy
metaphysician	metaphysician
sixty-two	sixty-two
surrounding	surround - ing
southward	southward
fleeting	fleet - ing
midst	midst
marvellous	marvellous
graver	grav - er
increase	increase
chimneys	chimneys
forms	form - s
geographically	geographical - ly
museum	museum
forget	forget
window-sill	window-sill
wretched	wretch - e - d
ants	ant - s
rulers	ruler - s
defeated	defeat - ed
spun	s - p - un
chant	chant
tradition	tradition
universal	un - ivers - al
priest	priest
diminution	diminution
problems	problem - s
programme	programme
saying	s - aying
thinks	think - s
sharper	sharp - er
blackmarket	blackmarket
drinking	drink - ing
discovery	discover - y
renewed	re - new - ed
fascinating	fascinat - ing
teach	teach
everybody	everybody
goods	good - s
three-year	three-year
trays	tray - s
robbed	robb - ed
figures	figure - s
habitual	habitual
even	even
bestowed	bestow - ed
judges	judg - e - s
americas	america - s
reconnoitring	reconnoitring
conflict	conflict
grovelling	grovelling
fire	fir - e
searching	search - ing
human	human
threw	threw
systematically	systematic - ally
steps	step - s
self-satisfied	self- - satisfi - ed
wire	wire
caution	caution
plains	p - lain - s
questioned	question - e - d
excuse	excuse
deep-laden	deep-laden
temples	temple - s
sheets	sheet - s
restoring	re - stor - ing
translate	translat - e
battle	battle
untranslatable	un - translat - able
contrast	contrast
exulting	exulting
startlingly	startl - ing - ly
poster	poster
stupidly	stupid - ly
colourless	colour - less
ebbed	ebb - ed
daylight	day - light
shortly	short - ly
cover	cover
lawn	law - n
palimpsest	palimpsest
gasping	gasp - ing
overpoweringly	overpower - ing - ly
co-ordination	co-ordinat - ion
involves	involv - e - s
burned	burn - ed
deeply	deep - ly
accusing	accus - ing
irregularly	irregular - ly
waxen-faced	waxen-faced
warm	warm
five	five
expressed	express - ed
drafting	draft - ing
charity	charity
lottery	lottery
person	person
models	model - s
twenty-four	twenty-four
gentle	gentl - e
scramble	scramble
market-woman	market-woman
bony	bon - y
february	february
float	float
correctly	correct - ly
teaching	teach - ing
eagerly	eager - ly
ship	s - hip
likelier	likeli - er
yapped	yapped
house-by-house	house-by-house
desperate	desperate
submachine	submachin - e
thumping	thump - ing
tidal	tidal
clawed	claw - ed
always	al - way - s
twitched	twitch - ed
leader	lead - er
w	w
persecutions	persecution - s
angry	ang - ry
pilfering	pilfering
culture	cultur - e
experiment	experiment
adequate	adequate
swarms	s - warm - s
preserved	p - reserved
clinging	cling - ing
dresses	dress - es
hierarchy	hierarchy
journalists	journalist - s
family	family
credit	credit
unsympathetic	un - sympathetic
stirring	stirr - ing
issues	issu - es
puddle	puddle
slanting	s - lant - ing
squatted	squatt - ed
touch	touch
clocks	c - lock - s
parent	parent
out	out
stream	stream
virtuosity	virtuosity
coffee	coffee
trap	trap
memorial	memorial
ghost	ghost
numbers	number - s
pluscold	pluscold
ill-cut	ill-cut
rendering	render - ing
rifle	rifle
scrap	scrap
reactions	re - action - s
maintains	maintain - s
boyish	boyish
inquisitive	inquisit - ive
explosion	explosion
transparent	transparent
flushed	flushed
damp	damp
hips	hip - s
dung	dung
jolted	jolt - ed
fundamentally	fundamental - ly
disagreement	dis - agreement
live	live
questioners	question - er - s
slept	s - lept
sock	sock
diagram	diagram
prolefeed	prolefe - ed
kill	kill
sanctioned	sanction - ed
commonplace	commonplace
denouncing	denounc - ing
mist	mist
neurologists	neurologist - s
pavements	pavement - s
milky	milk - y
disease	dis - ease
coupons	coupons
conspicuous	conspicuous
gladly	glad - ly
nature	nature
scraggy	scraggy
berkhamsted	berkhamsted
parachute	parachute
rejoiced	re - joiced
contains	contain - s
comintern	comintern
ships	s - hip - s
etymological	etymological
crop	c - rop
garment	garment
reminded	re - mind - ed
mortality	mortal - ity
pushed	push - ed
silk	silk
desirable	desirable
plume	plume
arriving	arriv - ing
element	element
unfolded	un - fold - ed
black-marketeers	black-marketeers
overhearing	overhear - ing
fully	ful - ly
balminess	balmines - s
eurasian	eurasia - n
ceases	cease - s
capitalists	capitalist - s
forest	forest
freeze	freeze
vaporize	vaporize
victim	victim
youthful	youth - ful
wage	wag - e
pathos	p - athos
rotting	rott - ing
moustache	moustache
compilers	c - ompilers
cromwell	cromwell
needles	needle - s
unimaginable	un - imagin - able
wonderful	wonder - ful
drily	dri - ly
horizontal	horizontal
bullet	bullet
sole	sole
cough	cough
swayed	s - way - ed
transmitting	transmitt - ing
ungovernable	un - govern - able
immense	immense
comfortable	comfort - able
flicker	flicker
hip	hip
publicity	public - ity
scratch	scratch
tightly-knit	tightly-knit
fuses	f - use - s
tenets	tenet - s
victims	victim - s
course	course
quack	quack
sharing	shar - ing
drenched	drench - ed
gym-shoes	gym-shoe - s
completely	complete - ly
notices	notic - e - s
inherited	inherit - ed
clothing	cloth - ing
violence	violence
within	within
tampering	tamper - ing
guiltily	guiltily
silenced	silence - d
population	population
ultimately	ultimate - ly
humming	humming
entrusted	en - trust - ed
murmuring	murmur - ing
fleshy	flesh - y
sanctimonious	s - anctimoniou - s
unbelievably	un - believ - ably
shave	s - have
watering	water - ing
slowly	s - low - ly
stead	stead
random	random
easing	easing
spoken	spoken
paralysing	paraly - s - ing
improved	im - prov - ed
succumbed	s - uccumb - ed
spyhole	spyhole
filtered	filter - ed
condition	condition
extraordinarily	extraordinarily
incident	incident
infinitely	infinite - ly
venomously	venomou - s - ly
dazzling	dazzl - ing
fanaticism	fanatic - ism
kitchen	kitchen
inserted	insert - ed
seizing	seiz - ing
scores	scores
inventive	invent - ive
sloppiness	sloppine - s - s
vehicles	vehicle - s
ached	ache - d
display	dis - play
exceptional	exception - al
death	death
microphone	microphone
ends	end - s
photograph	photograph
transferring	transferr - ing
mostly	most - ly
conspire	conspire
uncovering	un - cover - ing
wandered	wander - ed
note	note
weaving	weav - ing
countersign	countersign
world-conquest	world-conquest
beams	beam - s
suffix	suffix
frenzy	frenz - y
whose	who - s - e
hence	hence
hammers	hammer - s
brass	bras - s
bigger	bigger
accents	accent - s
nostalgia	nostalgia
truck-load	truck-load
stunned	s - tunned
became	be - came
bothered	bother - ed
nest	nest
6079	6079
drinking-shops	drinking-shops
shifted	shift - ed
gasp	gasp
heavy	heavy
snow	s - now
vow	vow
funeral	funeral
drenching	drench - ing
little	little
cowardice	cowardice
drawn-in	drawn-in
believed	believ - ed
clean	clean
observant	observant
bicycle	bicycle
forefinger	fore - finger
pedantic	pedantic
sexless	sex - less
conditioning	condition - ing
remembering	remember - ing
throat	throat
opinions	opinion - s
sweet	sweet
ordinary-looking	ordinary-looking
committed	committ - ed
hockey-fields	hockey-field - s
fills	fill - s
amputated	amputat - ed
neolithic	neolithic
nib	nib
cheaper	cheap - er
normally	normal - ly
tribunal	tribunal
'ired	'ired
repression	re - press - ion
twenty-two	twenty-two
wait	wait
tears	tear - s
glorious	gloriou - s
attempt	attempt
organizing	organiz - ing
urinate	urinate
labyrinthine	labyrinthine
haggling	haggling
high	high
share	shar - e
malignant	malignant
monster	monster
overpowering	overpower - ing
crucial	crucial
aristocracies	aristocrac - ies
4th	4th
english	english
reddened	redden - ed
light	light
wilful	wilful
gorn	gorn
wrap	wrap
eminent	eminent
safeguards	safeguard - s
ordinary	ordinary
prevailing	p - re - vail - ing
abusing	abus - ing
dying	dying
gangsters	gangsters
external	external
size	s - iz - e
love-making	love-making
multifarious	multifarious
consisted	consist - ed
dickens	dickens
recognized	recogniz - ed
consists	consist - s
actuated	actuated
european	european
threading	thread - ing
discs	discs
day	day
surrendered	surrender - ed
draft	draft
view	view
grievances	grievances
unjust	un - just
hedge	h - edge
incredulous	in - credulous
solid	solid
chiming	chim - ing
dislocate	dislocat - e
leaving	leav - ing
curiosity	curiosity
blades	blade - s
japan	japan
markets	market - s
real	real
survive	survive
swirl	swirl
skilfully	skilfully
table-tops	table-top - s
bound	bound
sulkily	sulkil - y
smiles	smile - s
intentionally	intent - ion - ally
win	win
all	all
suggestive	suggest - ive
father-to-son	father-to-son
lighter	light - er
schoolmaster	schoolmaster
squeezed	squeez - ed
contourless	con - tourles - s
marks	mark - s
caesars	caesar - s
clutching	clutch - ing
sensation	sensation
ruling	ruling
15	15
sought	s - ought
displeasure	dis - pleasure
strive	strive
mainly	main - ly
annihilated	annihilat - ed
stupid	stupid
centralized	central - ized
wrung	wrung
yelled	yell - ed
desired	desir - ed
evade	evad - e
disorder	dis - order
ears	ear - s
become	become
feeling	feel - ing
distributed	distribut - ed
accomplish	accomplish
outside	out - side
spectacles	spectacle - s
sub-section	s - ub-section
superseded	s - uperseded
rigidity	rigid - ity
ugly	ugly
stood	s - too - d
hardship	hardship
eastward	eastward
controlled	controll - ed
panic	panic
exploited	exploit - ed
piercing	pierc - ing
safeguard	safeguard
dribble	dribble
butted	butted
hurrying	hurry - ing
proceedings	proceed - ing - s
chessboard	chessboard
imaginable	imagin - able
sleepiest	sleepi - est
'ole	'ole
irresistible	irresistibl - e
educated	educat - ed
officer	officer
low	low
isles	isle - s
parsons	parsons
civilized	civiliz - ed
pitched	pitch - ed
disquieting	disquieting
weaker	weak - er
caption	caption
fetched	fetch - ed
whereupon	whereupon
dirt	dirt
educational	educat - ion - al
decaying	decay - ing
sandy-haired	sandy-haired
d'	d'
disconnectedly	dis - connected - ly
reform	re - form
marking	mark - ing
spoke	s - poke
pumped	pump - ed
that	that
through	through
dissemble	dis - sembl - e
pictures	picture - s
preparing	prepar - ing
barriers	barrier - s
gratuitous	gratuitou - s
lid	lid
jailbird	jailbird
sorry	sorry
predestined	predestin - ed
aspect	a - spect
considered	consider - ed
flexibility	flexibility
din	din
while	whil - e
devised	devise - d
exercise	exercis - e
hymn	hymn
dominion	dominion
pitch-dark	pitch-dark
daunted	daunted
interior	in - terior
ointment	ointment
schoolchildren	school - children
angle-joint	angle-joint
girl	girl
breathing	breath - ing
stack	s - tack
allow	allow
syllables	syllable - s
receive	receiv - e
crawled	crawl - ed
commander	command - er
skin	skin
jobs	job - s
calculate	calculat - e
employed	employed
pyramid	pyramid
sixteen	sixteen
twelve	twelve
burning	burn - ing
laughed	laugh - ed
decline	declin - e
sitting-room	s - itting-room
rgime	rgime
clutch	clutch
shabby	shabby
showed	s - how - ed
hair	h - air
imbecility	imbecil - ity
good-bye	good-bye
effects	effect - s
hands	hand - s
meet	meet
merit	merit
traitor	traitor
remained	remain - ed
pretence	pretence
applause	applause
committees	committee - s
precious	p - recious
stagnant	stagnant
wicked	wicked
frequenting	frequent - ing
battering	batter - ing
patriotism	patriotism
phase	phase
heirs	heirs
pharaohs	pharaoh - s
mentality	mental - ity
impatiently	im - patient - ly
legendary	legend - ary
oily	oil - y
smaller	small - er
incurious	in - curiou - s
might	might
much	much
lipsticked	lipstick - ed
smells	smell - s
russians	russian - s
announcement	announce - ment
organization	organization
weapon	weapon
walk	walk
door	door
attributes	attribute - s
pair	pair
wide	wide
exclamations	exclamations
count	count
my	my
aloud	a - loud
indispensably	in - dispens - ably
derived	deriv - ed
office	office
inapplicable	inapplicabl - e
introduction	introduct - ion
floorspace	floorspac - e
pity	pity
eats	eat - s
enacted	enacted
india	india
sabotage	sabotage
table	table
convenient	convenient
asked	ask - ed
coin	coin
self-discipline	self- - discipline
cycle	cycle
pavement	pavement
vanishing	vanish - ing
suggests	suggest - s
restored	re - stor - ed
questioning	question - ing
eyeballs	eyeball - s
charlemagne	charlemagne
arrived	arriv - ed
destructiveness	destructive - ness
boots	boot - s
efficiently	efficient - ly
extract	extract
heavily	heavily
mocking	mock - ing
nothingness	nothing - ness
pamphlets	pamphlet - s
barman	barman
press	press
treated	treat - ed
composing	compos - ing
batch	b - atch
bore	bor - e
those	those
astrology	astrology
bottomless	bottom - less
sanity	s - anity
cabinet	c - abinet
rare	rar - e
jehovah	jehovah
marched	march - ed
perhaps	perhaps
'eard	'eard
ranges	rang - e - s
fist	f - ist
skill	s - kill
motive	motiv - e
vomit	vomit
cavity	cavity
flagrant	f - lagrant
stubborn	stubborn
hostages	hostages
astronomy	astronomy
prayer	pray - er
orifices	orific - e - s
acting	acting
occurred	occurr - ed
platform	platform
greenness	green - ness
smiled	smile - d
grab	grab
foreshadowed	foreshadow - ed
neutral	neutral
daily	daily
promises	promis - e - s
started	start - ed
falling	falling
statues	statue - s
entail	entail
counted	count - ed
wrapping	wrapping
ipril	ipril
white-counterpaned	white-counterpaned
initial	initial
tumbled	tumbl - ed
oceans	ocean - s
states	state - s
unconscious	un - consciou - s
centimetre	centimetre
included	includ - ed
ark	ark
adore	ador - e
again	a - gain
cringing	c - ring - ing
coarseness	coarse - ness
civil	civil
fur	fur
everywhere	everywhere
overhead	overhead
pitch	pitch
pleasant	pleasant
serve	serve
shoeless	shoeles - s
susceptible	susceptible
upside-down	upside-down
clearly	clear - ly
considerable	consider - able
bloated	bloat - ed
geographical	geographical
imbecile	imbecil - e
'e	'e
manual	manual
researches	re - search - e - s
wings	wing - s
laughter	laughter
actors	act - or - s
admission	admission
approval	approv - al
one-two	one-two
suit	suit
disappear	disappear
bashed	bashed
incidents	incident - s
packet	packet
imposture	imposture
watchful	watch - ful
decent	decent
porcelain	porcelain
crossed	cross - ed
fidgeted	fidget - ed
outlet	outlet
arbitrary	arbitrary
click	click
be	be
outlook	out - look
respites	re - spite - s
distinguishing	distinguish - ing
overfulfillment	overfulfill - ment
distorted	distort - ed
heroic	heroic
stairs	stair - s
pegging	pegg - ing
workers	work - er - s
dinned	din - n - ed
rank-and-file	rank-and-fil - e
onwards	onwards
wayward	wayward
streaming	stream - ing
w.	w.
unforgivable	unforgivabl - e
embrace	embrace
session	session
sad	sad
reasoned	reason - ed
chest	chest
mild	mild
variation	variation
smudge	smudge
fumes	fumes
ladling	ladl - ing
co-operating	co-operating
oneself	oneself
resign	resign
willingness	willing - ness
venerated	venerat - ed
stooped	s - tooped
eleventh	eleven - th
created	creat - ed
fanatics	fanatic - s
misty	mist - y
quoting	quot - ing
unequal	un - equal
rid	rid
sink	s - ink
resentfully	re - sent - ful - ly
earmarked	earmark - ed
gradually	gradual - ly
market	market
revert	revert
syme	syme
testicles	testicles
whom	whom
butter	b - utter
backwards	backward - s
perilously	perilous - ly
vicious	viciou - s
comprehended	comprehend - ed
abolition	abolition
drudgery	drudgery
punishable	punish - able
encouraged	encourag - ed
sorrows	sorrow - s
rubbishy	rubb - ish - y
shapeless	shape - less
survives	survive - s
directions	direct - ion - s
bunk	bunk
unopposed	un - oppos - ed
hatching	h - atch - ing
thirst	thirst
hitched	h - itch - ed
australian	a - ustralian
industriousness	industrious - ness
relearn	re - learn
toiled	toil - ed
peacefully	peaceful - ly
shining	shin - ing
speedwise	speed - wise
sandwiches	sandwiches
trustworthy	trustworthy
flew	flew
top-storey	top-storey
conquest	conquest
assembled	assembl - ed
daren't	daren't
warmth	warm - th
field	field
hole	hole
citizen	citizen
earthly	earth - ly
haunted	haunt - ed
toothless	tooth - less
'ouse	'ouse
untouchables	un - touch - able - s
pacific	pacific
level-headed	level-heade - d
capital	capital
wariness	wariness
cynicism	cynicism
extinguish	extinguish
geological	geological
kind	kind
yesterday	yesterday
continents	continents
exaggerated	exaggerat - ed
fluttering	flutter - ing
leprosy	leprosy
indoctrinate	indoctrinate
such	such
sleepily	sleepi - ly
waiters	wait - er - s
lavatory	lavatory
terrified	terrified
chooses	choos - e - s
raised	rais - ed
homes	home - s
flowering	flower - ing
recreation	recreation
involuntarily	in - voluntarily
crosspurposes	crosspurposes
grammatical	grammatical
reassuringly	reassur - ing - ly
lids	lids
oldfashioned	oldfashioned
abbreviated	abbreviat - ed
elaborate	elaborate
precision	precision
shirking	shirk - ing
sixties	sixties
chimed	chim - ed
formulate	formulate
sticky-eyed	s - ticky-eyed
shuddering	shudder - ing
sinecure	sinecure
lack	lack
lowered	low - er - ed
stovepipe	s - tovepipe
shadow-world	shadow-world
sports-shirt	sports-shirt
degrees	degrees
beseech	beseech
enquiry	enquiry
characterize	characterize
conqueror	conquer - or
uncovered	un - cover - ed
place	plac - e
bright-lit	bright-lit
discovering	discover - ing
forming	form - ing
undo	undo
instrument	instrument
confused	confus - ed
crinkle	c - rinkle
gents	gent - s
moulding	moulding
halfhearted	halfheart - ed
accompany	accompany
considerations	consideration - s
espionage	espionage
brazilian	b - razilian
belt	b - elt
level	level
inconceivable	in - conceivable
staccato	staccato
imperial	imperial
noise	noise
turf	turf
mass	mass
outraged	outrage - d
victories	victor - ies
dark-coloured	dark-coloured
reverberation	reverberat - ion
province	province
taking	taking
lock	lock
trembling	trembling
facecrime	facecrime
shirt	s - hirt
questions	question - s
development	develop - ment
immediate	immediate
truckload	truckload
winter	winter
'yde_park	'yde_park
admitting	admitt - ing
cheek	cheek
curtain	curtain
moss	mos - s
minutes	minute - s
outweighed	out - weighed
sir	sir
tauter	tauter
gang	gang
dashed	dash - ed
lymph	lymph
obeying	obey - ing
owe	ow - e
purposes	purpose - s
unsteadily	un - steadily
hinted	hint - ed
raids	raid - s
tended	tend - ed
recesses	recesses
textbooks	textbook - s
churches	church - e - s
speculative	speculative
offensive	offensive
guarding	guard - ing
parents	parent - s
systems	system - s
uninteresting	un - interest - ing
sheep-face	s - heep-face
propositions	proposition - s
spiritless	spirit - less
police	police
dealing	deal - ing
different	different
gripped	gripp - ed
obeyed	obey - ed
capacity	capacity
sixty	sixty
smooth	s - mooth
slammed	slamm - ed
wall	wall
indonesian	indonesian
terribly	terribl - y
illustration	illustrat - ion
recuperate	recuperat - e
distribution	distribut - ion
dog	dog
gorilla-faced	gorilla-faced
page-ends	page-ends
furiously	furiou - s - ly
hero	hero
loyalty	loyalty
edges	edge - s
disappointing	disappoint - ing
fluttered	flutter - ed
exit	exit
middle-sized	middle-siz - ed
apex	apex
stew	stew
vistas	vistas
unmasked	un - mask - ed
absurd	absurd
minute	minute
interfered	interfer - ed
irresistibly	irresistibl - y
accidental	accident - al
novels	novel - s
statements	statement - s
uselessly	useless - ly
nitric	nitric
torpedo	torpedo
own	own
convoluted	convoluted
ghostlike	ghost - like
succumbing	s - uccumb - ing
iii	iii
noticing	notic - ing
overcome	overcom - e
byron	byron
grass	grass
carried	carried
hideously	hideous - ly
paid	p - aid
adam	adam
burying	burying
cowardly	coward - ly
handful	hand - ful
suppress	suppress
overthrown	over - thrown
principal	principal
saviour	saviour
screamed	scream - ed
black-haired	black-haired
first	first
floor	floor
scientist	scientist
shore	shor - e
pretty	pretty
suppose	suppos - e
lists	list - s
screaming	scream - ing
mathematical	mathematical
carpet	carpet
filthiest	filthiest
hopefully	hopefully
persecuted	persecut - ed
armour-plating	armour-plating
woken	woken
engine	engine
carriages	carriage - s
clerks	clerks
reformers	re - form - er - s
half-nostalgically	half- - nostalgic - ally
ill-paid	ill-paid
pan	p - an
ruby	rub - y
tableaux	tableaux
wass	was - s
plunge	p - lung - e
analogies	analogies
reckoned	re - ckon - ed
comes	come - s
egypt	egypt
defeating	defeat - ing
focusing	focus - ing
life	life
luridly	luridly
hearth-stone	hearth-stone
rebelling	re - bell - ing
toilet	toilet
appeared	appear - ed
planning	plann - ing
vital	vital
mysterious	mysteriou - s
bareness	bareness
studying	study - ing
averted	avert - ed
truncheon	truncheon
streetlevel	streetlevel
his	hi - s
measured	measur - ed
brooches	brooches
molehill	molehill
orators	orator - s
thousandth	thousand - th
habit-forming	habit-form - ing
americans	american - s
disseminate	disseminate
successfully	success - ful - ly
despatches	despatches
policy	p - olicy
retaliation	retaliation
rigid	rigid
screwed	screw - ed
teacupful	teacup - ful
well-known	well-known
laws	law - s
overwhelming	overwhelm - ing
acquire	acquir - e
magnificent	magnificent
conceivable	conceivable
penitent	penitent
party	part - y
plausible	plausibl - e
mountain	mountain
sufficiently	sufficient - ly
i.e.	i.e.
unsaid	unsaid
yielding	yield - ing
aloofness	aloofness
anchored	anchored
smashing	smash - ing
granddaughter	grand - daughter
brown	br - own
apparent	apparent
chattering	c - hatter - ing
remembered	remember - ed
rocket	rocket
reverted	revert - ed
accumulation	a - ccumulat - ion
squealing	squeal - ing
documentation	document - at - ion
drop	drop
garden	garden
merge	merge
cheesy	cheesy
reaction	re - action
sniff	sniff
happen	happen
auxiliary	auxiliary
feral	fer - al
torment	torment
welling	well - ing
report	report
brawny	brawny
scrounging	scrounging
down	down
skipped	s - kipped
plentiful	plentiful
bishops	bishop - s
urinal	urinal
question	question
dried	dri - ed
drawed	draw - ed
refrained	refrain - ed
chisels	chisel - s
primitive	primitive
closing-time	closing-time
liberated	liberated
forty-five	forty-five
plain	p - lain
annihilate	annihilat - e
risk	risk
ugliness	ugliness
fallacy	fallac - y
emerged	emerg - ed
adoptive	adopt - ive
infallible	in - fallible
piles	pile - s
boggy	boggy
sting	s - ting
movements	movement - s
enjoy	enjoy
unsatisfying	un - satisfy - ing
outer	out - er
enormity	enormity
instincts	instinct - s
strategic	strategic
popularity	popular - ity
knowing	know - ing
poorer	poorer
tens	tens
tobacco	tobacco
fail	fail
conception	concept - ion
impossible	im - possible
pay-out	pay-out
tap	tap
altered	alter - ed
'm	'm
camps	camp - s
city	c - it - y
fecundity	fecundity
alien	alien
leg	leg
pleased	pleas - ed
beautiful	beautiful
enter	enter
posters	poster - s
ante	ant - e
admiration	admiration
unknowns	un - known - s
disobedience	dis - obedience
reducing	reduc - ing
re-learn	re- - learn
remarks	remark - s
judgements	judgement - s
wad	wad
softening	s - often - ing
smoking	smok - ing
bombardment	bombardment
sprawling	sprawl - ing
capable	capable
original	origin - al
snatching	snatch - ing
tonight	tonight
years	year - s
permit	permit
associates	associates
brink	brink
yield	yield
knight	knight
bellies	bell - ies
brick-red	brick-red
principle	principle
terrific	terrific
loud	loud
apathetic	apathetic
borne	born - e
communicate	communicat - e
cellars	cellars
communist	communist
inflicting	inflict - ing
thinkable	think - able
pronounce	pronounce
lord	lord
bringing	b - ring - ing
pipe	pipe
armies	armie - s
especially	especial - ly
fast	fast
music	music
sanguine	s - anguine
subtlety	subtlety
mistaken	mistake - n
spoon	spoon
armchair	a - rmchair
completed	complete - d
layer	lay - er
son	s - on
likewise	likewise
ipso_facto	ipso_facto
seventeen	seventeen
scene	scene
nimbly	nimbly
quantities	quantities
ogilvy	ogilvy
hideous	hideous
individual	individual
remain	remain
dials	dials
gesticulating	gesticulat - ing
absurdity	absurd - ity
oldthink	oldthink
equally	equal - ly
copied	copi - ed
purposive	purposiv - e
territories	territor - ies
splendid	splendid
stiff	s - tiff
sweating	sweat - ing
essential	essential
approach	approach
bag	bag
fullwise	fullwi - s - e
watery	water - y
confession	confess - ion
between	b - etween
domination	dominat - ion
marx	marx
messages	message - s
portions	portion - s
discomfort	dis - comfort
empire	empire
appealed	appeal - ed
olden	old - en
divorce	divorce
revolt	re - volt
officially	official - ly
middle	middle
technological	technological
aback	a - back
nut	nut
routes	rout - es
progress	progress
morally	moral - ly
swiftly	swift - ly
cherry-coloured	cherry-coloured
racketeering	racketeer - ing
beetle-like	beetle - -like
irrationally	irrationally
class	class
argument	argument
tight	tight
charged	charge - d
coarsely	coarse - ly
dulled	dull - ed
mark	mark
peculiarly	peculiar - ly
strongest	strong - est
marching	march - ing
folly	fol - ly
but	b - ut
sexual	sexual
rival	rival
shocked	shock - ed
sociologists	sociologists
tricks	trick - s
living	living
unbent	un - bent
intermittent	intermittent
dictate	dictat - e
irritating	irritat - ing
rather	rather
maddened	madden - ed
'er	'er
naked	naked
monument	monument
rations	ration - s
seemed	seem - ed
offer	offer
concentration	concentrat - ion
comma	comma
sound-track	sound-track
smuggled	smuggl - ed
pin	p - in
passion	pass - ion
rendezvous	rendezvou - s
remind	re - mind
sooty	sooty
stripping	s - tripp - ing
recrossing	re - cross - ing
terrible	terribl - e
ill-omened	ill-omened
afford	a - fford
tangier	tangier
period	period
inflame	in - flame
register	register
limits	limit - s
interspersed	inter - s - persed
convey	convey
readiness	readi - ness
cylinder	cylinder
shirk	shirk
decided	decid - ed
bending	b - ending
displays	dis - play - s
politics	politics
ancient	ancient
opposite	opposite
generations	generation - s
underworld	un - derworld
regulated	regulat - ed
rejects	reject - s
set	s - et
bough	bough
suggested	suggest - ed
perceptible	perceptibl - e
direct	direct
rooms	room - s
loyal	loyal
threes	three - s
links	link - s
ownlife	ownlife
believe	believ - e
energy	energ - y
fading	fading
balancing	balanc - ing
cooking	cook - ing
fingering	finger - ing
citizens	citizen - s
living-room	living-room
kicking	kick - ing
planet	planet
cheeks	cheek - s
misunderstanding	mis - understand - ing
sequel	sequel
devotees	devot - e - es
friends	friend - s
oilstove	oilstov - e
tempo	tempo
utopias	utopia - s
validity	validity
clumsily	clumsi - ly
stratum	stratum
fullest	full - est
carefree	carefree
clump	c - lump
cried	cri - ed
imprisonments	imprisonment - s
mongolia	mongolia
altogether	al - together
buggers	buggers
call	call
subscriptions	subscription - s
indefinitely	in - definite - ly
nerve	nerve
shriek	shriek
tiny	tin - y
dwelt	dwelt
dream	dream
fiftyseven	fiftyseven
still-popular	s - till-popular
twist	twist
copying	copy - ing
whined	whin - ed
anxiety	anxiety
finish	finish
respect	re - spect
clothes	clothe - s
nobody	nobody
never-questioned	never- - question - ed
grammes	grammes
personal	person - al
commemorate	commemorat - e
differed	differed
blackmail	blackmail
shorten	short - en
compensation	compensation
psychologist	psychologist
drank	drank
hand	hand
civilizations	civilization - s
eggs	eggs
immensely	immense - ly
largely	larg - e - ly
nevertheless	nevertheless
mayor	may - or
fair	f - air
darling	darl - ing
demonstrative	demonstrat - ive
battlefield	battlefiel - d
evil	evil
goldsteinism	goldstein - ism
play	play
savings	saving - s
gripping	gripp - ing
impending	im - p - ending
specific	specific
voice	voic - e
uncover	un - cover
corridor	corridor
facts	f - act - s
understood	understood
expend	expend
belched	belch - ed
staying	stay - ing
inflexion	in - flexion
ribs	ribs
inextricably	inextricabl - y
rest	rest
delight	delight
engaged	engag - ed
betray	betray
clot	c - lot
contracted	con - tract - ed
ineffectual	ineffectual
reasons	reason - s
debauchery	debauch - er - y
adding	adding
solitary	solitary
wearied	weari - ed
spectacle-flash	spectacle-flash
panics	panic - s
poetry	poetry
asking	a - s - king
peeling	peeling
defend	defend
great-grandmother	great-grandmother
waged	wag - ed
cost	cost
assume	assum - e
waking	waking
interrogating	interrogat - ing
swing	s - wing
stir	stir
bounded	bound - ed
sympathetically	sympathetic - ally
strolled	stroll - ed
colonial	colonial
yes	ye - s
ducked	duck - ed
anyone	anyon - e
saliva	saliva
loosestrife	loosestrife
film	film
swarming	s - warm - ing
moreover	moreover
modern	modern
tomorrow	tomorrow
cells	c - ell - s
jargon	jargon
upon	upon
countries	countries
valued	value - d
rasped	rasp - ed
popped	p - opp - ed
fussy	fuss - y
idea	idea
three	three
sunken	s - unk - en
progressive	progress - ive
battered-looking	battered-looking
action	action
businesslike	business - like
miniplenty	mini - plenty
mastodons	mastodon - s
busy	bu - s - y
forces	forc - e - s
meaning	meaning
caricaturist	caricaturist
minds	mind - s
suspicious	s - uspicious
troop	troop
complex	complex
self-destruction	self- - destruction
languages	language - s
everyday	everyday
proper	proper
mirrored	mirror - ed
quality	quality
marked	mark - ed
portugal	portugal
nouns	noun - s
claim	claim
coolness	coolness
seven	s - even
right	right
blissful	bliss - ful
dwarf	dwarf
eighty	eight - y
flickered	flicker - ed
tribute	tribute
insect	in - sect
presence	presence
frank	f - rank
longing	long - ing
female	female
wires	wire - s
pointing	point - ing
lacquered	lacquered
bb	bb
improvisation	im - p - rovisation
deceiving	deceiv - ing
century	centur - y
noses	nose - s
signal	sign - al
sluttish	s - luttish
translating	translat - ing
aquiline	aquiline
they	the - y
try	try
closebitten	closebitten
discrimination	discrimination
thou	thou
didnt	didnt
practitioners	practitioners
101	101
odious	odious
fight	fight
matches	match - e - s
indirect	in - direct
unperson	un - person
lowest	lowest
casually	c - asually
smart	s - mart
wallop	wallop
patrol	patrol
remaining	remain - ing
heaved	heave - d
alibi	alibi
private	privat - e
triumph	triumph
distraction	distraction
thinkpol	thinkpol
seeing	seeing
yellow	yellow
appropriate	appropriate
cent	cent
pistol	pistol
northern	north - er - n
penetrating	penetrat - ing
inscriptions	inscription - s
outflank	outflank
impudent	impudent
promised	promis - ed
boiled	boil - ed
crisis	crisis
detachments	detachments
latest	latest
bottle-stopper	b - ottle-stopper
harshly	harsh - ly
couldn't	couldn't
pouring	pour - ing
re-edit	re-edit
jewess	jewess
mental	mental
simply	simpl - y
vestibule	vestibul - e
arrests	arrest - s
pole	pole
preferred	p - re - ferr - ed
pacing	p - acing
swaying	swaying
inherent	inherent
constant	constant
scrutinized	s - crutiniz - ed
submarine	s - ubmarine
valet	valet
wrist-watch	wrist-watch
tune	tune
selfish	selfish
agate	a - gate
bird	bird
morsel	morsel
blossoming-period	blossoming-period
medium	medium
name	name
spectacle	spectacle
combatants	combatants
verging	verg - ing
rung	rung
clean-mindedness	clean-mindednes - s
boasted	boast - ed
present	present
morality	morality
danes	danes
labour-camp	labour-camp
race	race
atrocity	atrocity
labyrinth	labyrinth
eradicate	eradicate
chaucer	chaucer
belonged	belong - ed
es	es
past	past
implication	implicat - ion
principles	principle - s
3	3
denies	deni - e - s
sensational	sensation - al
homosexuality	homosexual - ity
shove	shov - e
belfry	belfry
desire	desir - e
pugnaciously	pugnaciously
wildly	wild - ly
caught	caught
title-page	title-pag - e
undermines	undermine - s
disgustedly	disgust - ed - ly
flitted	f - litt - ed
dare	dare
calls	call - s
weakness	weakness
art	art
seats	s - eat - s
emptied	empti - ed
originally	origin - ally
rich	rich
mob	mob
cargo-ships	cargo-ships
committee	committee
patiently	patient - ly
jowl	jowl
window-pane	window-pane
destruction	destruction
independence	in - depend - ence
create	creat - e
kinds	kind - s
permanence	permanence
encircling	encircl - ing
dismay	dismay
tapping	tapp - ing
nests	nest - s
ailing	a - iling
annoyance	annoyanc - e
hysteria	hysteria
greycoloured	greycolour - ed
quailed	quail - ed
lootings	loot - ing - s
malreported	malreport - ed
exaltation	exaltation
false	false
guards	guard - s
dreamy	dream - y
dull	dull
feebly	feebl - y
lackeys	lackeys
london	london
midsentence	midsentence
receded	reced - ed
illusions	illusion - s
rotten	rott - en
barbed-wire	barbed-wir - e
scratched	scratch - ed
smell	smell
drudges	drudges
joints	joint - s
mutilating	mutilat - ing
lives	live - s
sexuality	sexuality
ruler	ruler
ancestors	ancestors
soluble	s - oluble
blow	blow
sexcrime	sex - crime
stepped	s - tepp - ed
equivocation	equivocation
whitestubbled	whitestubbl - ed
shoreditch	shoreditch
leopoldville	leopoldvill - e
africa	africa
sorrowful	sorrow - ful
offering	offer - ing
sewing-thread	sewing-thread
varies	varie - s
value	value
dividing	divid - ing
technically	technical - ly
hockey	hockey
ration	ration
perishes	perish - e - s
getting-up	getting-up
heaps	heaps
uncontrollably	un - controll - ably
ruled	rule - d
crudest	crudest
rush	rush
fine	fine
periodical	periodical
amputate	amputat - e
dono	dono
betrayal	betrayal
commotion	commotion
crises	cri - s - es
industrious	industrious
justification	justifi - cation
agitation	agitat - ion
forgiveness	forgiven - es - s
shop	s - hop
streamers	stream - er - s
contemplated	contemplat - ed
court	court
hybrid	hybrid
forgery	forgery
diminishing	diminish - ing
like	like
gymnasium	gymnasium
inexhaustible	inexhaustibl - e
kick	kick
answerable	answer - able
ain't	ain't
shan't	s - han't
crept	c - rept
amalgam	amalgam
ways	way - s
tossed	tossed
modify	modify
rain	rain
unquestioning	un - question - ing
activities	activitie - s
includes	includ - es
deal	deal
startled	startl - ed
jerkily	jerkily
prestige	p - restige
solidarity	solidarity
sub-committee	sub- - committee
bet	b - et
groups	group - s
closely	clos - e - ly
england	england
peaceful	peaceful
speaks	speak - s
consciousness	consciou - s - ness
locks	lock - s
gathered	gather - ed
goat	goat
leisure	leisure
spelling-book	s - pelling-book
achievements	achievement - s
oligarchies	oligarch - ies
existence	exist - ence
possessed	possess - ed
withers	withers
ages	age - s
demoralization	demoralization
master	master
kettle	kettle
meantime	meantime
accepting	accept - ing
untruthful	un - truthful
demonstrating	demonstrat - ing
suited	suit - ed
crazy	crazy
ungood	un - good
writing-table	writing-table
designing	design - ing
gateleg	gateleg
golden	gold - en
cube	cube
provisional	provisional
assassination	assassination
stamping	stamp - ing
household	household
green-shaded	green-shaded
impounded	impound - ed
seriously	serious - ly
ran	ran
jewish	jewish
helps	help - s
ratholes	rathole - s
wrong-doing	wrong-doing
eight	eight
steel	s - teel
83	83
strange	s - trange
seduction	s - eduction
air-raids	a - ir-raids
shaped	shape - d
unnoticed	un - notic - ed
examples	example - s
schoolmasterish	schoolmaster - ish
and	an - d
passageway	passageway
temple	temple
outnumbering	out - number - ing
cheat	cheat
specially	s - pecial - ly
rifles	rifle - s
recover	re - cover
twenty-three	twenty-three
well-timed	well-tim - ed
then	the - n
borrow	borrow
focused	focus - ed
put	p - ut
extremely	extreme - ly
laugh	laugh
overlordship	overlordship
tightened	tight - en - ed
puddles	puddle - s
metal	met - al
gilded	gilded
intellectual	intellectual
ideal	ideal
intellectuality	intellectual - ity
moved	move - d
grease	greas - e
half-hour	half-hour
silliness	silliness
gulped	gulp - ed
consisting	consist - ing
junior	junior
totalitarian	totalitarian
moving	moving
weaklings	weakling - s
indignation	indignation
abiding	abiding
launched	launch - ed
credulous	credulous
triumphing	triumph - ing
nudging	nudging
humiliate	humiliat - e
profited	p - rofited
valuable	valuable
]	]
caterpillars	caterpillars
red-armed	re - d-arm - ed
rickety	rickety
ink	ink
lunch	lunch
very	very
defeat	defeat
competition	c - ompetition
cowards	coward - s
gazing	gazing
loins	loins
checked	check - ed
reinstated	reinstat - ed
rope	rop - e
sure	sure
wild-rose	wild-rose
plucked	p - luck - e - d
grounded	ground - ed
strong	strong
lagged	lagged
bump	bump
cream-papered	cream-papered
among	a - mong
freely	free - ly
represented	re - present - ed
soaring	soar - ing
exhortations	exhortations
dayorder	day - order
corresponding	corresponding
improving	im - prov - ing
puts	p - ut - s
recreated	re - creat - ed
save	sav - e
unanswered	un - answer - ed
factories	factor - ies
rules	rule - s
indecipherable	indecipher - able
uncold	un - cold
capitulated	capitulate - d
longer	long - er
spooned	spoon - ed
dearest	dearest
tolerant	tolerant
faltered	f - alter - ed
hammering	hammer - ing
performed	perform - ed
lump	lump
speedful	speed - ful
mouthful	mouthful
millions	million - s
pervert	pervert
straggled	s - traggl - ed
stumbled	s - tumbl - ed
talking	talk - ing
consciously	consciou - s - ly
wearing-down	wearing-down
humand	humand
floors	floor - s
spasm	spasm
aims	aim - s
continuing	continu - ing
significant	significant
postcards	postcards
act	act
recurs	re - cur - s
savage	savage
squeeze	squeez - e
offence	offence
nodded	n - odd - ed
heave	heave
russian	russian
bad	bad
horrify	horrify
exciting	excit - ing
elegant	elegant
steady	stead - y
stiffened	stiffen - ed
coming	coming
outline	outline
hallway	hallway
'ad	'a - d
speakwritten	speak - written
super-state	super-state
abject	abject
public	public
suits	suit - s
gas	gas
technicians	technician - s
excitement	excit - e - ment
mess	me - s - s
aristocracy	aristocrac - y
careless	careless
losing	losing
thoughtcriminals	thought - criminal - s
logical	logic - al
forerunners	forerunners
shutter	shutt - er
complaining	complain - ing
show-pieces	show-pieces
tails	tail - s
month	month
depends	depend - s
wife	wife
urine	urine
apron	apron
ask	ask
bleat	bleat
assumed	assum - ed
disposal	dispos - al
adoration	adorat - ion
skirt	skirt
wrote	wrot - e
over'ead	over'ead
hiding-places	hiding-place - s
watches	watch - e - s
lessons	lesson - s
celibacy	celibacy
gift	gift
morning	morn - ing
pressed	press - ed
punished	punish - ed
cubic	cubic
plan	plan
benefit	benefit
tables	table - s
urgent	urgent
wrenches	wrench - e - s
interfering	interfer - ing
blackberry	blackberry
dampness	dampne - s - s
derisive	derisive
modes	modes
pressing	press - ing
enormous	enormous
moloch	moloch
dissent	dis - sent
planes	plan - e - s
upset	upset
inferiors	inferior - s
proclaiming	proclaim - ing
answering	answer - ing
replaced	re - plac - ed
sub-editors	sub-editor - s
developed	develop - ed
frantically	frantic - ally
concave	concave
regretful	regretful
feel	feel
racing	racing
accidental-like	accident - al - -like
floats	float - s
dropped	dropp - ed
sick	sick
white	white
feature	feature
genuine	genuine
silent	silent
trumpet	trumpet
sleeplessness	sleeplessnes - s
intrigues	intrigue - s
dilapidated	dilapidated
leading	lead - ing
alterable	alterable
cares	car - e - s
effigy	effig - y
attract	attract
ending	ending
enema	enema
inscrutable	inscrutable
love-offering	love-off - er - ing
eighteenth-century	eighteenth-century
physical	physical
inkstained	inkstained
plumping	p - lump - ing
gangs	gang - s
poison	poison
refilled	re - fill - ed
scuttle	scuttl - e
organized	organiz - ed
waving	waving
poured	pour - ed
creamy	creamy
ease	ease
reverberating	reverberat - ing
wake	wake
crumbled	crumbl - ed
impassively	impassively
biting	biting
describe	describ - e
steam	s - team
threat	threat
fighting	fight - ing
downhill	downhill
faint	faint
therefore	therefore
rightly	right - ly
dupes	dupes
maintained	maintain - ed
stain	s - tain
dignity	dignity
betrayed	betray - ed
drowned	drown - ed
uncomfortably	un - comfort - ably
abbreviations	abbreviat - ion - s
unrepentant	un - repentant
felt	felt
enemies	enemies
tablets	tablet - s
think	think
overwork	overwork
sneak	sneak
quota	quota
transparency	transparency
carriage	carriage
tips	tip - s
tirelessly	tireless - ly
larger	larg - er
ablest	a - b - lest
springing	spring - ing
multitude	multitude
recovered	re - cover - ed
motor-cars	motor-car - s
practices	practice - s
desultorily	desultorily
reverence	reverenc - e
interlude	interlude
chaos	chaos
comprises	comprise - s
international	international
superfluous	s - uperfluou - s
flavoured	flavoured
object	object
schooldays	schoolday - s
splinters	splinters
in	in
disdainfully	disdainfully
appreciate	appreciat - e
ideologically	ideological - ly
dumped	dump - ed
dark	dark
recalling	re - call - ing
sensuality	sensuality
greeted	greet - ed
loneliness	loneliness
waves	wave - s
massing	mass - ing
an	an
plugged	p - lugged
spinal	spinal
spanners	spanner - s
paraphernalia	paraphernalia
holy	hol - y
manage	manag - e
inflect	inflect
bulging	bulg - ing
slumped	s - lump - ed
compose	compos - e
dodged	dodge - d
drinks	drink - s
satisfies	satisfi - es
crushed	crush - ed
mighty	might - y
parts	part - s
waistline	waistlin - e
seventeen-twenty	seventeen-twenty
doings	doing - s
product	product
beam	beam
eddies	eddie - s
safest	safest
issued	issu - ed
woke	woke
beans	bean - s
flogged	f - logg - ed
innocence	innocenc - e
linger	linger
stumpy	stump - y
dangerous	dangerous
breeds	breed - s
unorthodox	un - orthodox
proles	prole - s
influence	influence
hurl	hurl
levitation	levitation
imperfectly	im - perfect - ly
studied	s - tudied
vocabulary	vocabulary
frivolity	frivolity
wiped	wiped
ancestral	ancestral
waists	waist - s
sailors	sailors
submerged	submerg - e - d
causes	caus - e - s
disengage	dis - engag - e
dustbins	dustbin - s
embed	emb - ed
camouflage	camouflag - e
irritably	irritably
tops	top - s
99	99
swiftly-moving	s - wiftly-moving
there	there
gyroscope	gyroscope
unwilling	un - willing
yellow-faced	yellow-faced
fever	f - ever
magenta	magenta
expending	expend - ing
simpler	simpl - er
getting	getting
month-old	month-old
etc.	etc.
instruction	instruction
predict	predict
snatched	snatch - ed
indefatigably	in - defatigabl - y
dirty-mindedness	dirty-mindedness
martial	martial
encountered	encounter - ed
commodity	commodity
untidy	untidy
debauch	debauch
could	c - oul - d
touching	touch - ing
methods	method - s
exception	exception
able	able
because	becau - s - e
reassurance	reassur - ance
proclamation	proclamation
upward	upward
cult	cult
slender	s - lender
superstates	superstat - e - s
sour	s - our
endorsed	endorsed
late	late
cheap	cheap
likened	liken - ed
visited	visit - ed
analysing	analys - ing
passport	passport
semblance	sembl - ance
resulting	result - ing
photographs	photograph - s
antique	antique
implicate	implicat - e
looted	loot - ed
large	larg - e
cure	cur - e
foresaw	foresaw
lecture	lecture
'eart-strings	'eart-string - s
empirical	empirical
aim	aim
worked-out	worked-out
chanted	chant - ed
differences	difference - s
inside	in - side
one	one
reclamation	reclamation
buildings	build - ing - s
solution	s - olut - ion
cents	cent - s
deleting	deleting
mattered	matter - ed
files	f - iles
inquisitor	inquisit - or
did	did
trumpet-call	trumpet-call
shattering	s - hatter - ing
potato	potato
afternoons	afternoon - s
extricate	extricate
niggling	niggling
straight	straight
guesswork	guesswork
(	(
mean-looking	mean-look - ing
thirties	thirtie - s
footstep	footstep
security	security
release	re - lease
vulgar	vulgar
walls	wall - s
lightly	light - ly
demeanour	demeanour
liked	like - d
choosing	choos - ing
conferred	con - ferr - ed
thoughtfully	thought - ful - ly
strand	strand
scuffles	s - cuffles
enormously	enormous - ly
forecasts	forecast - s
deep	deep
marriages	marriage - s
softpalmed	softpalmed
trusted	trust - ed
blackness	b - lacknes - s
obliquely	oblique - ly
shoes	shoe - s
authoritative	a - uthoritative
bolster	bolst - er
gently	gentl - y
midnight	midnight
goodthinked	goodthink - ed
poem	poem
smile	smile
toes	to - e - s
fortress	fortress
scrawny	scrawny
house-front	h - ouse-front
raid	raid
everyone	everyon - e
assault	assault
acrid-smelling	acrid-smell - ing
brief-case	brief-case
gunsights	gunsight - s
perpetuating	perpetuating
seconds	second - s
by	by
contemptuous	contemptuou - s
self-confidence	self- - confidence
vaporizations	vaporizations
park	p - ark
happy	happy
tried	tri - ed
crimethink	crimethink
inexorably	inexorably
scent	s - cent
plunged	p - lung - ed
rubber	rubb - er
power	power
spaces	s - pace - s
twinge	twinge
kindly	kind - ly
convicting	convict - ing
frightful	f - right - ful
bludgeon	bludgeon
deprecating	deprecating
leaning	lean - ing
packing	pack - ing
phrases	phrase - s
justly	just - ly
flood	flood
shrubs	shrubs
produce	produc - e
alive	a - live
approved	approv - ed
insidious	insidious
damn	damn
swap	swap
rectify	re - ctify
proving	prov - ing
whistled	whistle - d
opened	open - ed
allusion	allusion
straighter	straight - er
often	often
selling	sell - ing
behaviour	behaviour
obey	obey
pillory	p - illory
weekly	week - ly
bastards	bastard - s
scuttling	scuttl - ing
devastating	devastating
lest	lest
racial	racial
render	render
texture	texture
flagstones	flagstones
tradesman	tradesman
bonds	bonds
debated	debate - d
emotions	emotion - s
illiteracy	illiteracy
would	would
shirts	s - hirt - s
filtering	filter - ing
contents	content - s
quill	quill
acts	act - s
temperature	temperature
cigarette	cigarette
healthier	healthier
hour	hour
dripped	dripp - ed
bother	bother
thing	thing
antarctic	antarctic
indefinite	in - definite
prostitution	p - rostitution
detailed	detail - ed
suitably	suitabl - y
it	it
enough	enough
hysterically	hysterically
shapeliness	s - hapeliness
saccharine	saccharin - e
armed	arm - ed
opposites	opposite - s
proved	prov - ed
conquer	conquer
looser	loos - er
pre-revolutionary	p - re- - revolutionary
treachery	treacher - y
fiddling	fiddl - ing
contradicted	contradict - ed
encircled	encircl - ed
periodicals	periodical - s
tormented	torment - ed
intoxicating	intoxicat - ing
fifteen	fifteen
savages	savage - s
responsible	responsible
capering	c - apering
unseen	un - seen
trolleys	trolleys
distinct	distinct
guv'nor	guv'nor
rolling	roll - ing
suppressed	suppress - ed
self-evident	self- - evident
coherent	coherent
jerky	jerk - y
practice	practic - e
teachings	teach - ing - s
persist	persist
transmitted	transmitt - ed
continue	continu - e
eyebrows	eyebrow - s
immortal	im - mortal
examination	examin - at - ion
murmurous	murmurous
tingling	tingling
wrenched	wrench - ed
moments	moment - s
clasping	clasp - ing
rag	rag
mortally	mortal - ly
clanged	clang - ed
thrown	thrown
disproved	dis - prov - ed
american	american
now	now
information	in - formation
relationships	relationship - s
point	point
ruinous	ruinous
abnormality	abnormality
materialized	material - ized
mechanically	mechanical - ly
texts	texts
formed	form - ed
push	push
varicose	varicose
diseases	dis - ease - s
national	nation - al
manufactured	manufacture - d
ruggedly	ruggedl - y
sticky	sticky
relays	relays
stroked	stroke - d
weaken	weak - en
creatures	creature - s
select	select
boys	boy - s
air-conditioned	air-conditioned
countryside	countryside
distinctions	distinct - ion - s
collectivization	collectivization
ruins	ruin - s
ju	ju
successors	success - or - s
club	club
stuffed	stuff - ed
booklets	booklet - s
dingy	dingy
delivered	deliver - ed
nervously	nervous - ly
antiseptic	antiseptic
join	join
villainous	villainous
uncured	uncured
non-political	non-political
wood	wood
supplied	suppli - ed
gallon	gallon
hear	hear
tragic	tragic
greater	great - er
commonly	common - ly
adopted	adopt - ed
indeed	in - deed
clots	c - lot - s
trampled-on	trampled-on
feminine	feminine
phraseology	phraseology
antiques	antique - s
hebrew	hebrew
give	give
civilians	civilians
paper-clip	paper-clip
really	real - ly
radio	radio
sitting	sitt - ing
undergone	undergone
species	specie - s
show	show
numerous	numerous
stove	s - tove
disgusting	disgust - ing
melted	melt - ed
complicate	complicate
mate	mat - e
incapable	in - capable
sidelong	sidelong
periods	period - s
adjust	adjust
forearms	forearms
blankets	blanket - s
rotund	rotund
chap	chap
undisputed	un - disputed
remarkable	remark - able
uniform	uniform
gnawing	gnawing
recognize	recogniz - e
vain	vain
network	network
readily	readi - ly
zip	zip
clung	c - lung
drink	drink
cries	cri - e - s
lifts	lift - s
speakwrite	speakwrite
distances	distance - s
sky	sky
sticking-plaster	s - ticking-plaster
unexpectedly	un - expect - ed - ly
interpose	interpos - e
sebastian	sebastian
arms	arm - s
offensively	offensive - ly
must	must
paraded	parade - d
wreck	wreck
perceive	perceiv - e
gulfs	gulfs
disposing	dispos - ing
overfulfilled	overfulfill - ed
racketeers	racketeer - s
assign	a - s - sign
three-hour	three-hour
mealtimes	mealtimes
titular	titular
practic	practic
subdivided	s - ubdivid - ed
sessions	session - s
sometimes	sometimes
frame	frame
attachment	attach - ment
wavers	wavers
primary	primary
kaleidoscope	kaleidoscope
retrace	retrace
workings	work - ing - s
capitulate	capitulate
upside	upside
strength	strength
agony	agony
classes	class - es
dressing	dress - ing
striding	strid - ing
sane	sane
fifties	fifties
met	met
recurred	recurr - ed
thirty-nine	thirty-nine
swine	s - win - e
excelled	excell - ed
softened	s - often - ed
refer	re - fer
cyst	cyst
iceland	iceland
interest	interest
credulity	credulity
shortlived	shortliv - ed
newspaper	newspaper
drowning	drown - ing
dance	dance
paymasters	paymasters
workmate	workmate
him	him
mike	mike
twenty-five	twenty-five
swells	s - well - s
cast	cast
doorstep	doorstep
reeked	reek - ed
tea	tea
care	car - e
foot-track	foot-track
puritanism	p - uritanism
pinkish-grey	pinkish-grey
banner	banner
misery	miser - y
meals	meal - s
wars	war - s
patches	patch - e - s
knell	knell
historic	historic
softness	softnes - s
furtively	furtive - ly
thirtyone	thirtyone
promising	promis - ing
basement	basement
accepted	accept - ed
nasty	nast - y
hiding	hiding
description	descript - ion
ropes	rop - e - s
namely	name - ly
aggressive	aggressive
roughed	rough - ed
deafeningly	deafen - ing - ly
he	he
lungs	lung - s
pump	pump
bering	be - ring
beliefs	belief - s
disappearance	dis - appearance
eliminated	eliminat - ed
occupy	occupy
tremulous	tremulous
sickened	sicken - ed
corrections	correct - ion - s
knocking	knock - ing
greetings	greet - ing - s
lettering	letter - ing
dubleplusungood	dubleplusungoo - d
drawer	draw - er
glasses	glass - e - s
sheltering	shelter - ing
supported	support - ed
recapture	re - capture
due	due
notebook	notebook
develop	develop
half-litre	half-litre
blue	blue
recruit	recruit
moment	moment
nonexistent	nonexistent
rolls	roll - s
eradicated	eradicate - d
truck	truck
aaronson	aaronson
nuclei	nuclei
delusion	delusion
scheme	scheme
crudely	crude - ly
impressed	impress - ed
evading	evad - ing
apply	app - ly
besieged	besieged
business	business
discountenanced	discountenanc - ed
livid	livid
toward	toward
grinding	grinding
berlin	berlin
bandaged	bandaged
centimetres	centimetre - s
channels	channels
truncheons	truncheon - s
hate	hat - e
apparatus	apparatus
shout	shout
re-arrested	re- - arrest - ed
sport	sport
atrocities	atrocities
counter-revolutions	counter- - revolution - s
gymnastics	gymnastics
laundering	launder - ing
outlaws	outlaws
whirled	whirl - ed
overflowing	overflowing
worried	worri - ed
becomes	become - s
stampede	stamp - ed - e
roots	root - s
lassitude	lassitude
east	east
deviation	deviation
dwelling-houses	dwelling-house - s
handfuls	handfuls
sprouted	sprout - ed
gets	get - s
solar	solar
shouted	shout - ed
crumbling	crumbl - ing
freezes	freeze - s
meanings	mean - ing - s
relied	re - lie - d
briefly	brief - ly
gleaming	gleam - ing
praise	p - rais - e
programmes	programme - s
catch	catch
freed	free - d
oh-o-o-o-oh	oh-o-o-o-oh
continuity	continu - ity
latent	latent
nerves	nerve - s
struggles	struggl - es
40	40
failed	fail - ed
hairy-eared	hairy-eared
regulation	regulat - ion
advance	advanc - e
monkey	monkey
romantic	romantic
super-states	super-state - s
escape	escape
perversion	pervers - ion
lower	low - er
combination	combination
mattresses	mattress - e - s
isolated	isolat - ed
true	true
eroticism	eroticism
inscrutability	inscrutability
over-ripe	over-ripe
beamed	beam - ed
torpid	torpid
delegates	delegates
squares	square - s
prepositional	p - re - position - al
suffocation	suffocation
shadowy	shadowy
protector	protect - or
coverlet	coverlet
words	word - s
ladle	ladl - e
starvation	starv - at - ion
inprecorr	inprecorr
notion	notion
influenced	influence - d
remarked	remark - ed
advancing	advanc - ing
2+2=5	2+2=5
appreciatively	appreciat - ive - ly
dark-blue	dark-blue
bought	b - ought
eastasia	eastasia
opposing	oppos - ing
half-forgotten	half- - forgotten
fright	f - right
sternly	stern - ly
spiral	spiral
bulge	bulg - e
inalterable	in - alterable
shalt	s - halt
the	the
holds	hold - s
horror	horror
drearily	drearily
wakefulness	wakefulnes - s
marbled	marbled
speaking	speak - ing
unpacked	unpack - ed
chuck	chuck
forgotten	forgotten
cheery	cheer - y
harmless	harmles - s
triumphantly	triumphant - ly
overtime	overtim - e
strained	s - train - ed
awkwardness	awkward - ness
functions	function - s
inhabited	in - habit - ed
ripped	ripped
are	are
scholarly	scholar - ly
bullets	bullet - s
reality-control	reality-control
handy	hand - y
preliminary	preliminary
branch	branch
respite	re - spite
solid-looking	s - olid-look - ing
emotion	emotion
nursing	nursing
grasp	grasp
muscles	muscles
rapidly	rapid - ly
abominably	abominably
comprehensive	comprehensive
sling	sling
counter-revolutionary	counter- - revolutionary
hung	hung
pounds	p - ounds
reducible	reducibl - e
tuneful	tuneful
surprising	s - urpris - ing
up-and-down	up-and-down
absentmindedly	absentmind - ed - ly
constructions	construction - s
excellence	excell - ence
natural	natural
tin	tin
vocabularies	vocabularie - s
undesirable	un - desirable
inalienable	in - alien - able
broad	broad
mustard	mustard
hi	hi
never-mentioned	never- - mention - ed
whoever	whoever
defective	defect - ive
miserable	miser - able
imitate	imitat - e
uncertainty	un - certainty
resurrected	resurrect - ed
howling	howling
else	else
dice	dice
striven	s - triven
worker	work - er
research	re - search
accept	accept
self-contained	self- - contain - ed
ended	end - ed
shape	shape
elbows	elbow - s
german	german
direction	direct - ion
noted	not - ed
trumpets	trumpet - s
alley	all - e - y
ninth	ninth
neatness	neatne - s - s
order	order
cock-crow	cock-crow
search	search
example	example
designed	design - ed
horseback	horseback
accomplished	accomplish - ed
ate	at - e
biased	bias - ed
statuesque	s - tatuesque
length	length
rectification	rectifi - cation
osiris	osiris
rewritten	re - written
entailed	entail - ed
clicking	click - ing
interval	interval
lighted	light - ed
reconstruct	re - construct
seventy-five	seventy-five
shoulder	shoulder
sums	sum - s
though	though
microphones	microphone - s
pursue	pursu - e
teledep	teledep
antefiling	antefil - ing
feed	feed
prisoner	prisoner
matchwood	matchwood
bicep	bicep
claims	claim - s
sincerity	s - incerity
excited	excit - ed
painted	paint - ed
chunk	c - hunk
subjection	subject - ion
cat-o'-nine	cat-o'-nine
knot	knot
bluebell	bluebell
finished	finish - ed
incompatible	in - compatible
evident	evident
august	august
imagination	imagin - at - ion
exploded	exploded
demur	demur
claiming	claim - ing
musician	musician
devil	devil
twigs	twig - s
usage	usage
flags	flags
executive	execut - ive
directive	direct - ive
skimmed	skimm - ed
sandpaper	sandpaper
sake	s - ake
tickle	tickl - e
ill-favoured	ill-favour - ed
ridiculous	ridiculous
until	until
sash	s - ash
coldness	coldness
concealment	conceal - ment
delivering	deliver - ing
appear	appear
renting	rent - ing
persecuting	persecut - ing
returned	re - turn - ed
menacingly	menac - ing - ly
sordid	s - ordid
tunic	tunic
slab	s - lab
called	call - ed
nearly	near - ly
meagreness	meagre - ness
bored	bored
abandoned	abandon - ed
dial	dial
jones	jones
moment-to-moment	moment-to-moment
translations	translat - ion - s
fragmentary	fragment - ary
constantly	constant - ly
purple	purple
wave	wave
theoretically	theoretical - ly
conquering	conquer - ing
hereditary	hereditary
footpath	footpath
boil	boil
populous	populous
smallest	small - est
banquet	banquet
bluebells	bluebell - s
obscenity	obscenity
talked	talk - ed
high-heeled	high-heeled
worked	work - ed
side	side
jerks	jerk - s
rumbling	rumbling
invite	invit - e
dedicated	dedicat - ed
doubt	doubt
motor-car	motor-car
pairs	pair - s
pub	pub
news	new - s
swift	swift
odour	odour
quivering	quiver - ing
quoted	quot - ed
beetle	beetle
singlet	s - inglet
tedious	tedious
drastically	drastically
indirectly	in - direct - ly
alcove	alcove
flimsy	flimsy
spy	s - py
mortgage	mortgage
stirred	stirr - ed
imaginings	imagin - ing - s
contrived	contrived
rose-hip	rose-hip
next	next
eclipse	eclips - e
ant	ant
eighteen-thirty	eighteen-thirty
discredit	discredit
gratefully	grate - ful - ly
containing	contain - ing
doorways	doorway - s
attractive	attract - ive
accordance	accord - ance
deed	deed
chairs	chair - s
endlessly	endless - ly
coated	coat - ed
colchester	colchester
sub	s - ub
age	age
unbidden	unbidden
audible	audibl - e
skies	skies
weakly	weak - ly
political	political
forlorn	forlorn
orders	order - s
campaign	campaign
cause	caus - e
gravely	grav - e - ly
mated	mat - ed
paraphrase	paraphrase
oblivion	oblivion
belonging	belong - ing
cardinal	cardinal
overheads	overhead - s
midsummer	midsummer
ear-splitting	ear-splitting
positive	positive
shorthand	s - horthand
response	response
corruption	corrupt - ion
see	see
choose	choos - e
sewers	sewer - s
somewhat	somewhat
confesses	confess - e - s
stamp	stamp
emotionally	emotion - ally
involving	involv - ing
chanced	chance - d
stop	s - top
standards	standard - s
terrifying	terrifying
free	free
clumsy	clumsy
bumps	bump - s
crack	crack
fierce	fierce
lasted	last - ed
sacred	sacr - ed
nipper	nipp - er
pledge	pledge
kid	kid
utilitarian	utilitarian
over-sixteens	over-sixteens
'ead	'ead
price	p - rice
technicalities	technical - ities
ruffianism	ruffian - ism
industrial	in - dustrial
moves	move - s
troubling	troubl - ing
washtub	washtub
opening	open - ing
pealing	pealing
buy	bu - y
interchangeability	in - terchangeability
changed	change - d
loving	loving
partition	partition
commanding	command - ing
accurate	accurate
underwater	un - derwater
dwelling-places	dwelling-places
vast	vast
possess	possess
'at	'at
individualism	individual - ism
inequality	in - equal - ity
experienced	experience - d
strapped	strapp - ed
doesn't	doesn't
award	award
bow	bow
insemination	in - s - emination
negatived	negative - d
ceylon	ceylon
breeze	breeze
realize	realiz - e
falsified	falsified
crowd	crowd
aroused	a - roused
firmly	firm - ly
grey	grey
squads	squad - s
dim	dim
knoll	knoll
listen	listen
climates	climate - s
abundantly	abundantly
dark-brown	dark-brown
cowered	cower - ed
seizure	seizur - e
stroll	stroll
absolute	absolute
baby	baby
let	let
look	look
frequented	frequent - ed
ceilings	c - eilings
tendencies	tendencies
focus	focus
atlantic	atlantic
elm	elm
hat	hat
unusual	un - usual
flopped	flopp - ed
utter	utter
watched	watch - ed
fitted	fitt - ed
hypodermic	hypodermic
beyond	beyond
two-ounce	two-ounce
white-tiled	white-tiled
dressed	dress - ed
surrounded	surround - ed
grasped	grasp - ed
indifferently	in - different - ly
chasing	chas - ing
relaxation	relaxation
sporadically	sporadical - ly
finger	finger
bristled	bristled
slight	s - light
nightmare	nightmare
earthenware	earthenwar - e
disengaged	dis - engag - ed
oceania	oceania
annihilation	annihilat - ion
sale	s - ale
blew	blew
calm	calm
daydream	daydream
fascination	fascinat - ion
partisanship	partisanship
undetected	un - detect - ed
blurry	blurry
afterwards	afterwards
forests	forest - s
whiff	whiff
dace	dace
polysyllabic	polysyllabic
stopped	stopp - ed
knees	knee - s
mask	mask
commandments	command - ment - s
fatter	f - atter
favoured	favoured
hesitation	hesitation
oppressed	oppress - ed
band	band
self-forgetfulness	self-forgetfulness
corrugated	corrugat - ed
corrupted	corrupt - ed
swallowers	swallow - er - s
privacy	privacy
expressions	express - ion - s
thumb	thumb
began	began
yet	yet
chair	chair
apparently	apparent - ly
raising	rais - ing
noble	noble
arrows	arrow - s
manoeuvre	manoeuvr - e
avenue	avenue
gabbling	gabbl - ing
synthetic	synthetic
1940	1940
combine	combine
confirmation	confirmation
stupidity	stupid - ity
falsification	falsification
mottled	mottl - ed
thoughtcrime	thoughtcrime
solitude	solitude
deep-lunged	deep-lung - ed
pasture	p - asture
handle	handle
re-educating	re- - educat - ing
intellectuals	intellectual - s
likely	like - ly
similar	similar
'ave	'av - e
calf	calf
needless	needle - s - s
sister-in-law	sister-in-law
dress	dress
reduced	reduc - ed
elegantly	elegant - ly
's	's
cattle-track	cattle-track
never	never
physically	physical - ly
plunger	p - lung - er
songs	song - s
adverbs	adverb - s
unimagined	un - imagin - ed
chastity	c - hast - ity
decadence	decadence
14.2.84	14.2.84
coat	coat
communicating	communicat - ing
darwin	darwin
don't	don't
freedom	freedom
frost	frost
only	only
uniformity	uniform - ity
hollow	hollow
ninety	ninety
red	red
clankclank	clankclank
speakwrites	speakwrite - s
145	145
provide	provide
constricted	con - strict - ed
clamoured	clamoured
flown	flow - n
collections	collect - ion - s
type	type
dominated	dominat - ed
time	time
deserved	deserved
snow-white	snow-white
abounds	a - bound - s
nineteen	nineteen
member	member
lamps	lamp - s
older	old - er
strip	s - trip
austere	austere
blond-headed	blond-headed
trousers	trousers
benevolent	benevolent
medicine	medicine
disappeared	disappear - e - d
flattened	flatten - ed
stallkeepers	stallkeeper - s
oiled	oil - ed
bodies	bodies
delay	delay
far	far
gauge	gauge
sandyhaired	s - andyhaired
struggling	struggl - ing
telescoped	telescoped
verifying	verify - ing
listening	listen - ing
brief	brief
heads	head - s
sold	s - old
defences	defences
peculiar	peculiar
effigies	effig - ies
nearer	near - er
've	'v - e
cabbage	cabbage
doing	doing
departments	department - s
oceanic	oceanic
year	year
3,000	3,000
invariably	invariabl - y
leafless	leafles - s
were	were
nobby	nobby
off	off
purity	purity
centres	centre - s
bulk	bulk
blood-ties	blood-ties
fled	f - led
pointless	point - less
ruined	ruin - ed
infrequently	in - frequent - ly
paris	p - aris
draw	draw
children	children
refugees	refugee - s
well-defined	well-defined
breathed	breath - ed
concern	concern
beard	bear - d
sufficient	sufficient
teen	teen
privileges	privilege - s
trick	trick
unmistakably	unmistakabl - y
dripping	dripp - ing
speeded	speed - ed
quarters	quart - er - s
economic	economic
beat	beat
weight	weight
renamed	re - name - d
sallower	s - allow - er
tinier	tinier
curve	curv - e
return	re - turn
remorselessly	remorselessly
definition	definition
pleasanter	pleasant - er
thickly	thick - ly
treacheries	treacher - ies
winning	winn - ing
lift-shaft	lift-shaft
reappearance	re - appearance
side-street	side-street
discontents	dis - content - s
myriad	myriad
women	women
dully	dull - y
counting	count - ing
multiplied	multiplied
bulkiness	bulkiness
remainder	remain - d - er
pot	pot
devices	device - s
closing	clos - ing
staring	star - ing
retaining	re - tain - ing
lengthways	lengthways
unwritten	un - written
bourgeoisie	bourgeoisie
present-day	present-day
racked	racked
alternately	alternatel - y
extended	extend - e - d
faculty	faculty
happiness	happiness
doors	door - s
hers	her - s
carrot	carrot
concealing	conceal - ing
as	as
sees	see - s
tested	test - ed
gyrating	gyrat - ing
traitors	traitor - s
demanded	demand - ed
rash	rash
motives	motiv - e - s
handwriting	hand - writing
resettled	resettl - ed
regimented	regimented
rapings	raping - s
nodding	nodding
soles	sole - s
conspirators	conspirator - s
collectively	collectiv - e - ly
faintness	faint - ness
quarts	quart - s
enveloping	envelop - ing
notes	not - e - s
indoor	in - door
heart	heart
animal	animal
anonymous	anonymous
organism	organism
defended	defend - ed
inflicted	inflict - e - d
projecting	project - ing
repairing	re - pair - ing
stability	stability
worries	worri - e - s
parted	p - art - ed
amateur	amateur
fertile	fertile
violently	violent - ly
capitals	capital - s
steadily	steadily
deliver	deliver
told	tol - d
lands	land - s
stacked	s - tack - ed
invented	invent - ed
affected	affect - ed
average	averag - e
enemy	enemy
est	est
slinging	sling - ing
treading	tread - ing
crooked	crook - ed
rags	rag - s
spinning	spinn - ing
behind	behind
about	about
alone	alone
bedroom	bedroom
cylindrical	cylindrical
armada	armada
dared	dare - d
outrages	outrage - s
making	making
admonished	admonish - ed
swirled	swirl - ed
admit	admit
novelettes	novelettes
dipped	dippe - d
block	block
jam	jam
oily-tasting	oily-tasting
friend	friend
stupor	stupor
syphilis	syphili - s
coverless	cover - less
welcome	welcom - e
hiding-place	hiding-place
artist	artist
united	unit - ed
fewer	few - er
welled	well - ed
wrapped	wrapped
sneeze	s - neeze
nineteen-thirty	nineteen-thirty
dozing	dozing
cool	c - ool
lenses	lenses
intensity	in - tens - ity
eastasian	eastasia - n
miscellaneous	miscellaneou - s
served	serve - d
so-and-so	so-and-so
conquered	conquer - ed
compulsion	compulsion
appeals	appeal - s
blanket	blanket
colder	cold - er
springy	spring - y
entirely	entire - ly
prison	prison
consigned	con - sign - ed
preached	p - reach - ed
lectures	lecture - s
stalls	s - tall - s
persevered	persever - ed
cease	cease
fertilized	f - ertilized
funny	funny
regularly	regular - ly
stricken	s - trick - en
illuminate	illuminate
snatches	snatch - e - s
artsem	artsem
assailed	assail - ed
main	main
rhine	rhine
increasing	in - creas - ing
criticize	criticize
game	game
perfectly	perfect - ly
enclosing	en - clos - ing
secure	secur - e
orderly	order - ly
seizes	seiz - e - s
audience	audience
story	stor - y
loyalties	loyalties
equatorial	equatorial
mannerism	manner - ism
shown	show - n
device	device
legend	legend
change	change
hand-spans	hand-spans
gloating	gloat - ing
pouched	pouch - ed
second	second
poverty	p - overt - y
threats	threat - s
recognizing	recogniz - ing
corn	corn
primal	p - rimal
grimacing	grimacing
aware	aware
pools	p - ool - s
mood	mood
reinscribed	re - inscribed
unsinkable	unsinkable
reminiscently	reminiscently
accumulated	a - ccumulat - ed
use	use
vapid	vapid
comrades	comrade - s
gold	gold
counter-revolutionaries	counter-revolutionaries
hunting-down	hunting-down
mystique	mystique
dodges	dodge - s
application	application
agreement	agreement
stout	s - tout
suspicion	suspicion
passengers	passenger - s
mouth	mouth
reputation	re - p - utation
extend	extend
briefcase	briefcas - e
fortresses	fortress - es
persists	persist - s
surely	sure - ly
rubbed	rubb - ed
irresponsible	ir - responsible
cruelty	cruelty
perched	p - erched
painters	paint - er - s
producers	producers
inexhaustibly	inexhaustibl - y
reclaim	re - claim
sprinkle	s - p - rinkle
issue	issu - e
shower	show - er
should	s - hould
nazi	nazi
embracing	embrac - ing
muscular	muscular
regularity	regular - ity
drown	drown
government	government
prole	prole
gummed-up	gummed-up
staffs	staff - s
bud	bu - d
district	district
deportations	deportation - s
black	b - lack
discarded	discard - ed
spat	s - p - at
enumerate	en - umerat - e
danger	danger
barely	bar - e - ly
despairing	despair - ing
base	base
frankly	f - rank - ly
generalized	general - ized
maintain	maintain
meditatively	meditat - ive - ly
s	s
stocks	stock - s
stripped	s - tripp - ed
tasted	taste - d
astonished	astonish - ed
hours	hour - s
excluded	exclud - ed
hurry	hurry
number	number
lark	lark
cock	cock
trickery	trick - er - y
blunt	blunt
bells	bell - s
circle	circle
fat	fat
anthologies	anthologies
glance	glanc - e
monopoly	monopoly
simian	simian
stock	stock
underemployed	under - employed
preference	p - reference
soap	s - oap
fellow-tenant	f - ellow-tenant
underlying	under - ly - ing
digressions	digression - s
decades	decade - s
oranges	oranges
hostel	hostel
processes	process - es
self-deception	self- - deception
naggingly	nagging - ly
dictatorship	dictatorship
required	require - d
flinging	fling - ing
paraffin	paraffin
single-mindedness	s - ingle-mindednes - s
unwillingly	un - willing - ly
gradual	gradual
recollect	re - collect
boulders	boulders
gritty	gritty
tube	tube
securely	secur - e - ly
enjoyed	enjoy - ed
racket	racket
products	product - s
commit	commit
testimony	testimony
letter	letter
coloured	colour - ed
aint	aint
grasping	grasp - ing
futile	futile
nameless	nameless
chilly	chill - y
joint	joint
wispy	wispy
flying	f - lying
boo	boo
general	general
hungrily	hungri - ly
twenty	twenty
wrecking	wreck - ing
gravy	grav - y
mingled	mingled
philosophical	philosophic - al
believing	believ - ing
heel	heel
collector	collect - or
attracted	attract - ed
boos	boo - s
judgement	judgement
commemorating	commemorat - ing
landing	land - ing
intrigue	intrigue
salvation	salvation
unfreedom	un - freedom
inflamed	in - flam - ed
milk	milk
boy	boy
seditious	seditious
tie	tie
throats	throat - s
welded	weld - ed
scraps	scrap - s
harmonize	harmonize
twig	twig
foodstuffs	foodstuff - s
declared	declar - ed
throbbing	throbb - ing
snuffboxes	snuffbox - es
roar	roar
hike	hike
jealously	jealously
nagging	nagging
compared	compar - ed
storm	storm
flank	f - lank
climate	climate
incriminating	incriminat - ing
dreams	dream - s
spring	spring
scribbled	scribbl - ed
lemon	lemon
babies	babi - e - s
cared	car - ed
mathematicians	mathematicians
myself	myself
shaved	shav - ed
loses	lose - s
absorption	absorption
belongs	belong - s
flagstaffs	flagstaffs
fourpence	fourpence
corpses	corpse - s
upper	upper
specious	speciou - s
backslider	backslider
commented	commented
letters	letter - s
mirror	mirror
reassure	reassur - e
servants	s - ervant - s
telling	tell - ing
members	member - s
warriors	warriors
wrenching	wrench - ing
conformity	conformity
approached	approach - ed
sand-like	sand-like
minuteness	minute - ness
gases	gas - e - s
along	a - long
indicating	indicat - ing
innumerable	innumer - able
masters	master - s
drive	driv - e
oughter	ought - er
1973	1973
3.12.83	3.12.83
papers	paper - s
has	ha - s
shrivelled	shrivell - ed
speech	s - peech
straight-featured	straight-featured
dirty	dirt - y
distort	distort
looking	look - ing
glass	glass
restricting	re - strict - ing
theatre	theatre
overtones	overtones
whimpered	whimper - ed
early	ear - ly
lift	lift
scribbles	scribbl - e - s
damned	damn - ed
disliked	dis - like - d
tightly	tight - ly
changes	change - s
retained	re - tain - ed
rebellion	rebellion
gives	give - s
taken	take - n
levels	level - s
saturday	saturday
sausages	s - a - usage - s
wits	wits
discover	discover
home	home
dated	dat - ed
architecture	architecture
silver	s - ilver
won	won
chocolate-ration	chocolate-ration
induce	induc - e
managed	manag - ed
oozing	oozing
peered	p - eer - ed
reason	reason
riot	riot
tolerated	tolerate - d
bring	b - ring
speak	speak
documents	document - s
swim	swim
mindless	mindless
gulp	gulp
luminous	luminous
celebrate	celebrate
boredom	boredom
yellowish	yellow - ish
mention	mention
inefficient	in - efficient
satisfied	satisfi - ed
quick-witted	quick-witt - ed
verify	verify
statement	statement
flesh	flesh
comforted	comfort - ed
daughter	daughter
paler	paler
wet	wet
frock	f - rock
aggressively	aggressive - ly
chamber	chamber
packed	pack - ed
identified	identifi - ed
chill	chill
slid	slid
adored	ador - ed
paper	paper
creature	creature
terrace	terrac - e
looks	look - s
tearing	tear - ing
cloth	cloth
conduct	conduct
exists	exist - s
belief	belief
geography	geography
holding	hold - ing
omnipotent	omnipotent
darkened	darken - ed
cloves	c - love - s
tormenting	torment - ing
writers	writers
ashamed	a - sham - ed
association	association
baskets	basket - s
enthusiastically	enthusiastic - ally
gathering	gather - ing
explored	explore - d
gravitated	gravitat - ed
boxing-gloves	boxing-gloves
rumour	rumour
our	our
kaleidoscopes	kaleidoscope - s
bald	bald
contempt	con - tempt
eat	eat
gave	gave
systematic	systematic
arithmetical	arithmetic - al
dear	dear
extremity	extremity
wise	wise
corner	corn - er
made	mad - e
attendances	attend - ance - s
jagged	jagg - ed
rat	rat
starve	starv - e
plus	plu - s
scrubbed	s - crubb - ed
beside	beside
shall	s - h - all
lacked	lack - ed
dreamt	dreamt
proprietor	proprietor
uncontrollable	un - controllable
wasted	wast - ed
mane	man - e
greyish	greyish
apart	a - part
black-uniformed	black-uniform - ed
crook	crook
litres	litre - s
differentiated	differentiat - ed
fifty	fifty
thirteen	thirteen
conflicted	conflict - ed
intermittently	intermittent - ly
overheard	overhear - d
loosened	loosene - d
system	system
bumped	bump - ed
memories	memor - ies
hunk	hunk
intercommunication	inter - communicat - ion
cross	cross
duckspeak	duckspeak
height	h - eight
word-formation	word-formation
current	current
spies	s - pi - e - s
throwing	throw - ing
loose	loos - e
railing	rail - ing
telescreen	telescreen
spotting	spott - ing
entrails	entrail - s
partly	part - ly
erecting	erect - ing
practical	practic - al
sceptical	s - ceptical
irrespective	ir - respective
litter	litt - er
contradict	contradict
frontispiece	frontispiece
premonitory	premonitory
shame	sham - e
picking	pick - ing
invisibility	invisibility
happier	happier
fifteen-thirty	fifteen-thirty
treadmill	treadmill
french	french
running	running
execution	execut - ion
shop-front	shop-front
named	name - d
privileged	privilege - d
wondered	wonder - ed
ladders	ladder - s
shoulders	shoulder - s
slave	slave
beast-like	beast-lik - e
administrator	administrator
eyes	eye - s
voluptuous	voluptuous
instalments	instalments
still	s - till
indoors	in - door - s
bat	b - at
lit	lit
carelessly	careless - ly
sister	s - ist - er
mended	mend - ed
despicable	despicable
't	't
stake	s - take
intervals	interval - s
indians	indian - s
cautious	cautious
attempted	attempt - ed
flights	f - light - s
patch	patch
closed	clos - ed
lie	lie
leaden	leaden
privilege	privilege
demolish	demolish
impregnable	impregnable
run	run
mournful	mournful
sing	sing
2713	2713
mammoths	mammoth - s
reconciling	reconcil - ing
crash	crash
tortured	torture - d
amplifiers	amplifier - s
doomed	doom - ed
writing	writing
slightly	s - light - ly
maddening	madden - ing
facing	f - acing
colonies	c - olonie - s
waddled	waddl - ed
relinquishing	relinquish - ing
endure	endure
pediment	p - ediment
bench	bench
reasserted	re - assert - ed
democracy	democracy
move	move
tallish	tallish
tyranny	tyranny
active	activ - e
insulted	insult - ed
turning	turn - ing
counterpane	counterpane
dirty-looking	dirty-looking
reserved	reserved
building	build - ing
apologetic	apologetic
gone	gone
reduce	reduc - e
indignantly	indignantly
possibilities	possibilit - ies
amused	amused
gin-drinking	gin-drinking
goodwise	goodwise
dislocation	dislocation
sheer	s - h - eer
nice	n - ice
evidence	evidence
arrange	arrang - e
bulletins	bulletin - s
despotism	despotism
strictly	strict - ly
pile	pile
deadly	dead - ly
menacing	menac - ing
remote	remote
flicked	f - licked
flow	flow
route	rout - e
quarrels	quarrel - s
sheet	sheet
struggled	struggl - ed
impenetrable	impenetrable
musty	must - y
pardoned	pardon - ed
corked	cork - ed
precautionary	precautionary
respectively	respective - ly
foreigners	foreign - er - s
antiquity	antiqu - ity
patched-up	patched-up
currency	currency
abashed	a - bashed
concessions	concessions
meant	meant
suppression	suppress - ion
hot	hot
friendliness	friendliness
clement	clement
pulled	pull - ed
filing	f - iling
isolation	isolat - ion
nineteenth	nineteen - th
refrigerator	refrigerator
attacked	attack - ed
tasteless	taste - less
machine	machine
rub	rub
seemingly	seem - ing - ly
slip	s - lip
twenty-four-hour-a-day	twenty-four-hour-a-day
overturn	overturn
worth	worth
sentiment	sentiment
shut	s - hut
ragged	ragged
bullying	bully - ing
estimate	estimate
hong	hong
objective	object - ive
doubtful	doubtful
send	s - end
painting	paint - ing
distilled	dis - till - ed
arguing	argu - ing
accident	accident
coincidence	coincid - ence
entitled	entitled
quicken	quick - en
undoubtedly	un - doubt - ed - ly
feet	feet
intend	in - tend
explosions	explosion - s
function	function
informers	in - form - er - s
planted	p - lant - ed
suspended	s - uspended
endured	endure - d
tibet	tibet
insurrection	insurrection
deceive	deceiv - e
wool	wool
efficiency	efficiency
stiffen	stiffen
pink	p - ink
up-to-dateness	up-to-dateness
asleep	a - sleep
begotten	begotten
identifying	identifying
jest	jest
sadness	s - adness
cling	cling
acid	acid
devotion	devot - ion
ed	ed
fallen	f - all - en
poor	poor
suicidal	suicidal
stared	star - ed
wrappings	wrapping - s
holes	hole - s
sweltering	s - weltering
fortunes	fortunes
follows	follow - s
queues	queue - s
collect	collect
terms	term - s
parades	parade - s
unchangeable	un - change - able
write	write
consider	consider
hottest	hottest
attending	attend - ing
bandits	bandits
worse	wor - s - e
stepney	stepney
picture	picture
personally	person - al - ly
pouchy	pouch - y
old-fashioned	old-fashion - ed
guise	guise
organizers	organiz - er - s
darted	dart - ed
happened	happen - ed
cosmetics	cosmetics
persistence	persist - ence
procured	procur - ed
murderous	murderous
flight	f - light
deeper	deep - er
darts	dart - s
explains	explain - s
refugee	refugee
blackwhite	blackwhite
flower	flower
ideology	ideology
inner	inner
animated	animated
lever	lever
agonizingly	agonizing - ly
repeat	repeat
immunized	immuniz - ed
thicker	thick - er
spare	s - p - are
step	step
pig-iron	pig-iron
up	up
steamer	s - team - er
intention	in - tention
interpreted	in - terpreted
reconciliation	reconciliation
anybody	anybody
surprise	s - urpris - e
tour_de_force	tour_de_force
bushy	b - ushy
blown	blown
extent	extent
pace	pace
timber	timber
goodsex	goodsex
convulsive	convul - s - ive
filthy	filth - y
manner	manner
balls	b - all - s
activity	activ - ity
competed	compet - ed
continuous	continuous
drawn	draw - n
dinginess	dinginess
dimpled	dimpled
hemisphere	hemisphere
discretion	discretion
granite	granite
fault	fault
willow	willow
blowlamp	blowlamp
cultivated	cultivat - ed
cheer	cheer
previous	p - re - viou - s
uncle	uncle
latter	latter
secondly	second - ly
dense	dense
preponderance	preponderance
unsolved	un - solved
fund	fund
praising	p - rais - ing
keying	keying
arrive	arriv - e
make-up	make-up
hanging	hang - ing
perceptibly	perceptibl - y
machinery	machine - ry
digging	digg - ing
foretaste	fore - taste
fragile	fragile
repeated	repeat - ed
reappeared	re - appear - ed
rhythmical	rhythmic - al
roused	roused
tending	tend - ing
important	important
rate	rat - e
with	with
tolerates	tolerate - s
discussion	discus - s - ion
redhaired	redhair - ed
buttons	buttons
perished	perish - ed
emphasized	emphasized
heretic	heretic
abstractedly	abstract - ed - ly
crawling	crawl - ing
articles	article - s
maze	maze
shells	s - hell - s
diary	diary
insatiably	insatiably
boundaries	boundaries
warned	warn - ed
works	work - s
vomited	vomit - ed
categories	categories
brutal	br - utal
philosophies	philosoph - ies
roars	roar - s
riding	riding
conditions	condition - s
sagged	sagg - ed
sun	s - un
neutralized	neutralize - d
cancelled	cancell - ed
crocuses	crocus - e - s
formally	formal - ly
discoloured	dis - colour - ed
nicknamed	nickname - d
rooftops	rooftops
unflinchingly	unflinch - ing - ly
examined	examin - ed
detect	detect
guarded	guard - ed
bootlaces	bootlaces
gentler	gentl - er
surly	s - urly
ampoule	ampoule
teams	team - s
silkiness	silkines - s
pattered	p - atter - ed
gains	gain - s
faded	fade - d
afraid	a - f - raid
thee	the - e
winners	winn - er - s
smattering	s - matter - ing
commercial	commercial
shrunk	shrunk
rocks	rock - s
desk	desk
infallibility	infallibility
offices	office - s
capitalist	capitalist
goes	goes
york	york
bearing	bear - ing
education	educat - ion
truth-producing	truth-producing
pads	pad - s
tired	tired
houses	house - s
fold	fold
suspected	suspect - ed
eighteen	eighteen
subsided	subsid - ed
paused	paus - ed
hay	ha - y
doubts	doubt - s
fear	f - ear
archaic	archaic
capture	capture
caste	cast - e
drilling	drill - ing
coveted	c - ovet - ed
irritation	irritat - ion
machines	machine - s
image	im - age
ocean	ocean
surfaces	s - urface - s
earnest	earnest
failures	failure - s
pegs	p - eg - s
centary	cent - ary
wherever	wherever
choice	choice
springiness	springines - s
actuality	actual - ity
swallowed	swallow - ed
pronouns	pronoun - s
utterly	utter - ly
unconvincing	un - convinc - ing
totalitarians	totalitarian - s
reconciled	reconcil - ed
amid	amid
mouthfuls	mouthful - s
rosebud	rosebud
pull	pull
slipped	s - lipped
owns	own - s
waxed-faced	waxed-fac - ed
eh	eh
cruel	cruel
conspiracy	conspirac - y
suitable	suitabl - e
indispensable	in - dispens - able
memorable	memor - able
otherwise	other - wise
suffer	s - uffer
trusting	trust - ing
enrolling	enroll - ing
contradictions	contradict - ion - s
freckled	freckle - d
minded	mind - ed
endowed	endowed
shrivel	shrivel
uniforms	uniform - s
posts	post - s
exact	exact
impose	impos - e
common	common
vitriol	vitriol
troop-leader	troop-leader
offending	offend - ing
separated	separat - ed
shades	shade - s
business-like	business - -like
football	football
coats	coat - s
devoted	devot - ed
recognition	recognition
miniluv	miniluv
hotter	hotter
ingrained	in - grain - ed
shake	shake
handing-over	handing-over
fuel	fuel
subtle	subtl - e
gain	gain
prostrated	prostrated
left	left
meagre	meagre
circulated	circulat - ed
sign	sign
mouths	mouth - s
glamour	glamour
advanced	advanc - ed
lank	lank
withstand	withstand
candlestick	c - andlestick
print	print
twenty-six	twenty-six
eight-thirty	eight-thirt - y
relatives	relat - ive - s
sourish	sourish
whines	whin - e - s
professional	professional
impudently	impudent - ly
hoped	hop - ed
rabbits	rabbit - s
ready	read - y
inherently	inherent - ly
sodden	sodden
trial	trial
blubbered	blubber - ed
begin	begin
lamp	lamp
manners	manner - s
pillars	pillar - s
prostitute	prostitute
mixture	mixture
historical	historic - al
paxful	paxful
work-hardened	work-harden - ed
vainly	vain - ly
terror	terror
collective	collectiv - e
sweep	s - weep
haste	hast - e
heat	heat
wooden-seated	wooden-seated
does	do - e - s
careful	careful
coins	coin - s
survival	survival
kisses	kiss - es
luxury	luxury
faith	f - a - ith
usual	usual
attempts	attempt - s
growth	grow - th
television	televis - ion
crashed	crash - ed
exercise-books	exercise-books
severe	s - ever - e
unlike	un - like
slow	s - low
apple	apple
twisting	twist - ing
areas	area - s
promiscuity	p - romiscuity
wishing	wish - ing
confusion	confus - ion
beastly	beastly
after	after
colossus	c - olossu - s
event	event
processions	process - ion - s
sour-sweet	s - our-sweet
ffcc	ffcc
expensive	expensive
months	month - s
slide	slid - e
crackle	crackle
figured	figure - d
diffusing	diffusing
froglike	f - roglike
distant	distant
predictions	predict - ion - s
issuing	issu - ing
however	however
just	just
manchuria	manchuria
pannikin	pannikin
five-cent	five-cent
prosaically	prosaically
taught	taught
raspingly	rasp - ing - ly
deflated	deflated
adult	adult
fascinated	fascinat - ed
stank	s - tank
ministries	ministries
errors	error - s
regrouped	re - group - ed
relish	relish
wrist	wrist
eavesdropping	eavesdropp - ing
lead	lead
dumpy	dump - y
limbs	limb - s
against	against
pinchbeck	pinchbeck
twenty-first	twenty-first
whitened	white - n - ed
whimpering	whimper - ing
lies	lie - s
articulate	articulate
decoration	decorat - ion
peace	peace
meat	meat
nebulous	nebulou - s
sinking	s - in - king
bundled	bundle - d
portion	portion
seen	seen
uncorking	un - cork - ing
working	work - ing
underestimated	under - estimate - d
grime	grim - e
scientific	scientific
tablet	tablet
curved	curv - ed
song	song
disbelieve	dis - believ - e
hisses	hisse - s
breast	breast
cobbled	cobble - d
porch	p - orch
lapse	lapse
scrubbing	s - crubb - ing
tall	tall
antonyms	antonym - s
sham	sham
1920	1920
stamped	stamp - ed
strait	strait
teeth	teeth
loudly	loud - ly
unused	un - use - d
controllable	controllable
aristocrats	aristocrat - s
mythology	mythology
copper	c - opp - er
preoccupied	preoccupi - ed
confessions	confess - ion - s
saint	s - aint
followed	follow - ed
anticipation	anticipation
falsehood	f - alsehood
syllable	syllable
confer	confer
tic	tic
minipeaceful	mini - peaceful
hats	hat - s
senses	s - ense - s
hoisted	hoisted
trampled	trampl - ed
happens	happen - s
answer	answer
criminality	criminal - ity
bar-room	bar-room
furthest	furth - est
determined	determin - ed
discipline	discipline
permitted	permitted
pyramidal	pyramid - al
sorrowfully	sorrow - ful - ly
dreary	dreary
swollen	swollen
habits	habit - s
antibodies	antibodi - e - s
flashed	flash - ed
competent	compet - ent
raise	rais - e
barrel	barrel
occasionally	occasion - ally
die	die
sighed	sigh - ed
italics	italics
raw	raw
refused	refus - ed
argued	argu - ed
cloud	cloud
dialled	dialled
unanswerable	un - answer - able
restore	re - s - tore
panegyric	panegyric
slaves	slave - s
propped	propp - ed
grossly	grossly
alike	a - like
sell	s - ell
indifferent	in - different
assemble	assembl - e
room	room
under	under
moist	moist
misleading	mislead - ing
soup	soup
norman	norman
handing	hand - ing
other	other
british	british
monologue	monologue
cunning	cunn - ing
team	team
alley-ways	alley-ways
pneumatic	pneumatic
contradictory	contradict - or - y
journey	journey
basket	basket
service	s - ervic - e
eternal	etern - al
sweeping	s - weep - ing
codeword	codeword
giving	giving
metaphysics	metaphysics
nominate	nominate
she	s - he
ten	te - n
febrile	febrile
item	item
animals	animal - s
symbolize	s - ymbolize
calves	calves
hostile	hostil - e
greatest	great - est
denounced	denounc - ed
halfburying	halfbury - ing
clear	clear
drug-peddlers	drug-peddlers
over-production	over-production
inadequate	in - adequate
fattish	fattish
pale	p - ale
breadcrust	breadcrust
shorter	short - er
southern	southern
confinement	confinement
definitions	definition - s
inarticulate	in - articulate
roughened	rough - en - ed
stated	state - d
studios	studios
telescreens	telescreen - s
one-oh-one	one-oh-on - e
turn	turn
world-within-a-world	world-within-a-world
delicately	delicate - ly
allowing	allow - ing
pretentious	p - re - tentious
quart	quart
gorgeous	gorgeou - s
added	add - ed
tongue	tongu - e
plate	p - late
will	will
van	van
lemons	lemon - s
interests	interest - s
delirium	delirium
stratified	s - tratified
separate	separat - e
flaps	flap - s
firmness	firmness
blaring	blaring
blowing	blow - ing
contortionist	con - tortionist
translated	translat - ed
spine	spine
stress	stres - s
baking	b - a - king
physicist	physicist
believer	believ - er
possession	possession
speculations	s - peculations
burrow	burrow
emblem	emblem
goodness	goodnes - s
unvarying	unvarying
lipstick	lipstick
cauterized	cauterized
whiskers	whiskers
reduction	reduction
teacher	teach - er
erected	erect - ed
identity	identity
b-b	b-b
insufficient	in - sufficient
melancholy	melancho - ly
eyed	eye - d
verb	verb
naturally	natural - ly
sobering	s - obering
asia	asia
foreseen	foresee - n
heartland	heartland
rivals	rival - s
bumstead	bumstead
ensure	en - sure
limb	limb
blackmoustachio'd	blackmoustachio'd
touching-up	touching-up
)	)
reversible	reversible
wastage	wastage
useful	useful
recall	re - call
squatting	squatt - ing
capped	c - app - ed
instantly	instant - ly
intently	intent - ly
islands	islands
embarrassing	embarrass - ing
consumed	consum - ed
worthless	worth - less
prodigies	p - rodigies
silly	silly
badly	bad - ly
king	king
lately	late - ly
flared	flar - ed
invisible	in - visible
definitively	definitive - ly
kicked	kick - ed
said	s - aid
lose	lose
twenty-one	twenty-one
starting	start - ing
weep	weep
barren	barren
plumped	p - lump - ed
mutability	mutabil - ity
happening	happen - ing
instinctive	instinct - ive
transport	transport
mean	mean
characteristics	characteristic - s
half-aware	half-awar - e
least	least
fathoms	fathoms
heretics	heretic - s
legs	leg - s
oh	oh
pushing	push - ing
braying	braying
threadbare	threadbare
vilifies	vilifies
youth	youth
mat	mat
breaking	break - ing
seeming	seem - ing
stretched	stretch - ed
chanting	chant - ing
lip-service	lip-service
mr.	mr.
nineteen-twenty	nineteen-twenty
document	document
slanted	s - lant - ed
stamps	stamp - s
suffering	s - uffer - ing
continuation	continu - at - ion
infant	in - f - ant
lull	lull
land-mass	land-mass
reference	reference
devoured	devour - ed
scraped	scrap - ed
slate	s - late
smallish	small - ish
sustained	sustain - ed
tore	tore
ascribed	ascribed
dismembered	dis - member - ed
english-speaker	english-speaker
intimacy	intimacy
contained	contain - ed
listened	listen - ed
blankness	blank - ness
inspected	in - spect - ed
repositories	repositorie - s
inscription	inscription
intensely	in - tense - ly
musicians	musician - s
penknives	penknives
enveloped	envelop - ed
black-market	black-market
half-pleasant	half- - pleasant
queue	queue
beauty	beauty
deceit	deceit
referred	re - ferr - ed
unnecessary	un - necessary
populations	population - s
one-time	one-time
method	method
cork	cork
amulets	amulets
rebelliousness	rebellious - ness
rhythm	rhythm
stretching	stretch - ing
threaded	thread - ed
built	built
handled	handle - d
hoardings	hoard - ing - s
shouldn't	shouldn't
trophy	trophy
ill-defined	ill-defined
lightning	light - n - ing
daydreaming	daydream - ing
distasteful	dis - taste - ful
emptiest	empti - est
babbling	babbling
printed	print - ed
straps	s - trap - s
vision	vision
pulse	pulse
shallower	shallow - er
messenger	messenger
intricate	intricate
thousands	thousand - s
secondary	second - ary
water	water
suspect	suspect
indian	indian
afterthought	afterthought
ranging	rang - ing
eyeless	eyeles - s
jus_primae_noctis	jus_primae_noctis
regrouping	re - group - ing
sanction	sanction
realized	realiz - ed
chocolate	chocolate
bunch	bunch
leant	leant
rod	rod
half-darkness	half- - darkness
psychologically	psychologically
unimportant	un - important
tray	tray
red-hot	red-hot
counter-attack	counter-attack
forced-labour	forced-labour
buttocks	buttocks
school	school
trace	trac - e
mid-day	mid-day
intended	in - tend - ed
proclamations	proclamation - s
blazed	blaz - ed
copiously	copiously
fruity	fruit - y
inferior	inferior
oftener	often - er
pronounceable	pronounce - able
crowds	crowd - s
crude	crude
starts	start - s
spontaneous	spontaneous
world-view	world-view
bus	bu - s
clambering	c - lamber - ing
unconquerable	un - conquerable
'ats	'at - s
safely	s - afe - ly
friendship	friendship
sense	s - ense
alter	alter
task	task
bold	b - old
absence	absence
cleared	clear - ed
awake	a - wake
flaked	flake - d
lined	line - d
pudgy	pudgy
variations	variation - s
more	more
daydreams	daydream - s
parenthetically	parenthetically
conversation	conversation
assembly	assembl - y
empty	empty
go	go
'ealth	'ealth
execrate	execrate
arranged	arrang - ed
stand	stand
silence	silence
stinking	s - tink - ing
theories	theor - ies
existing	exist - ing
turned	turn - ed
chequered	chequer - ed
innocent	in - nocent
labours	labour - s
thieves	thieves
simple	simpl - e
manuals	manual - s
eyeing	eyeing
meself	meself
glory	glory
carnivorous	carnivorou - s
composite	composite
temporary	temporary
corking	cork - ing
institutions	institution - s
printingshops	printingshops
brainy	brain - y
resembled	re - sembl - ed
repeating	repeat - ing
obvious	obvious
hoarding	hoard - ing
pitying	pity - ing
water-closets	water-closets
droning	droning
ideals	ideal - s
occasional	occasion - al
authority	author - ity
sentimental	sentiment - al
bent	bent
examining	examin - ing
tales	tale - s
decisive	decis - ive
happenings	happen - ing - s
further	furth - er
uneasy	un - easy
abandon	abandon
where	where
debate	debate
acquaintance	acquaintance
obediently	obedient - ly
conceal	conceal
killed	kill - ed
once	once
letting	letting
flat	flat
unappeasable	un - appea - s - able
another	a - n - other
rainwater	rainwater
positions	position - s
sloping	s - loping
unbearably	un - bearably
germs	germs
sterner	stern - er
intimidating	intimidating
gagging	gagg - ing
goodthinker	goodthink - er
bottle	bottle
inventing	invent - ing
arm	arm
probably	probabl - y
reissued	re - issu - ed
western	western
harm	harm
bell	bell
persistent	persist - ent
cylinders	cylinder - s
archipelago	archipelago
unsatisfactory	un - satisfactory
servitude	s - ervitude
wish	wish
resurrection	resurrect - ion
war-criminals	war-criminals
obviously	obvious - ly
whichever	whichever
murder	murder
cherish	cherish
dozen	dozen
partners	partners
...	...
blond-haired	blond-hair - ed
roasting	roasting
leapt	leapt
celibate	c - elibate
cavernous	cavernous
objectivity	objectivity
indestructible	indestructible
adulterers	adulterers
admire	admire
obliged	oblig - ed
resolve	re - solve
roared	roar - ed
lady	lady
ravages	ravages
singled	single - d
youthfulness	youth - ful - ness
stifling	stifl - ing
dock	dock
helplessly	helpless - ly
love-affair	love-affair
strenuousness	strenuousnes - s
attitude	attitude
brotherhood	brotherhood
distinguish	distinguish
fatal	fat - al
underwent	underwent
shelter	shelter
pursuing	pursu - ing
weighted	weight - ed
declining	declin - ing
shots	s - hot - s
inclined	inclin - ed
accurately	accurate - ly
booziness	booziness
compound	compound
humanity	human - ity
humble	humbl - e
thirty	thirty
pronunciation	pronunciation
huge	huge
area	area
prefer	p - re - fer
ring	ring
specialists	specialist - s
looked	look - ed
glimpses	glimpse - s
swirls	swirl - s
glimpse	glimpse
labour	labour
encourage	encourag - e
secretively	secret - ive - ly
relevant	relevant
path	path
purges	p - urge - s
fireplace	fireplace
shallow	shallow
refines	re - fine - s
climax	climax
property	property
cap	cap
ramifications	ramifications
streaks	streak - s
argentina	argentina
want	want
disputed	disputed
waiter	wait - er
exhausted	exhaust - ed
died	died
attack	attack
overproduction	over - production
smelt	s - melt
2,000	2,000
performance	perform - ance
anodyne	anodyne
fanatic	fanatic
frenzies	frenz - ies
haunting	haunt - ing
lifted	lift - ed
reported	report - ed
tickets	tickets
duckspeaker	duckspeak - er
expect	expect
communal	commun - al
harsh	harsh
mutilated	mutilat - ed
prostitutes	prostitute - s
sharply	sharp - ly
nowhere	nowher - e
country	country
cell	c - ell
dominant	dominant
prettiness	pretti - ness
knife	knife
contain	contain
contacts	contact - s
countless	count - less
approximately	a - pproximately
apologetically	apologetic - ally
beating	beat - ing
eye	eye
inviting	invit - ing
prodded	p - rod - d - ed
awarded	award - ed
pretend	pretend
sun-filled	sun-fill - ed
every	ever - y
richness	richnes - s
unconnected	un - connected
exquisitely	exquisitel - y
hallucination	hallucination
utmost	utmost
accent	accent
catapult	c - atapult
add	add
nervous	nervous
can	c - an
rouged	rouge - d
incredulity	in - credulity
rouge	rouge
settle	settle
justified	justifi - ed
three-quarters	three-quarter - s
tracked	track - ed
liable	liable
bundle	bundle
craving	crav - ing
secrets	secret - s
redder	redder
blast	b - last
slightest	s - light - est
rasping	rasp - ing
determine	determin - e
axiom	axiom
pupil	pupil
resists	resist - s
criticism	criticism
shone	shone
deliberately	deliberate - ly
insults	insult - s
joined	join - ed
traps	trap - s
donkey	donkey
humblest	humbl - est
single	single
opinion	opinion
page	p - age
crumbly	crumbl - y
nearby	nearby
reprinted	re - print - ed
sounded	sound - ed
inheritance	inherit - ance
importance	im - portance
underground	under - ground
genially	geni - al - ly
decanter	decanter
fists	f - ist - s
ignored	ignor - ed
shares	shar - e - s
reluctantly	reluctant - ly
robbing	robb - ing
melt	melt
reflected	reflect - ed
incorrectly	in - correct - ly
shoe	shoe
awkwardly	awkward - ly
over	over
queer	queer
re-read	re- - read
restless	restless
trials	trial - s
1914	1914
bazaars	bazaars
case	case
ground	ground
barefoot	barefoot
rebelled	re - bell - ed
war	war
clasped	clasp - ed
victoriously	victoriously
swarmed	s - warm - ed
litre	litre
strongly	strong - ly
waters	water - s
codewords	codeword - s
china	china
overthrow	over - throw
ministry	ministry
horrible	horrible
subtler	subtl - er
sentimentally	sentiment - ally
bits	b - it - s
abuse	abus - e
reprisals	re - prisals
furious	furiou - s
uncomprehending	un - comprehend - ing
zoom	zoom
murdered	murder - ed
subsequent	subsequent
whispered	whisper - ed
streamed	stream - ed
persia	p - ersia
stops	s - top - s
threshold	threshold
anything	anything
determining	determin - ing
pigeon	pigeon
bookshelves	bookshelves
healthy	health - y
when	when
strategy	s - trategy
winston	winston
unintelligible	un - intelligible
shaftesbury	shaftesbury
hit	h - it
semi-divine	semi-divine
dictionary	dictionary
coined	coin - ed
corrected	correct - ed
features	feature - s
irregular	irregular
ache	ache
stationer	station - er
whining	whin - ing
ghosts	ghost - s
its	it - s
irregularities	irregular - ities
properly	proper - ly
rook	rook
literary	literary
cheated	cheat - ed
obeisance	obeis - ance
factor	factor
hierarchical	hierarchical
misprints	misprint - s
provided	provide - d
postpone	postpone
negroes	negroes
strident	s - trident
negroid	negroid
store	stor - e
lucid	lucid
us	us
tramp	tramp
deadlier	deadlier
pricked	prick - e - d
full	full
twig-littered	twig-littered
.	.
courtesy	courtesy
plank	p - lank
sagging	sagg - ing
whiteness	white - ness
tinged	ting - ed
evicted	evicted
longhoped-for	longhoped-for
preparations	preparation - s
singly	sing - ly
taste	taste
testing	test - ing
pool	p - ool
drum	drum
fourteen	fourteen
bearer	bear - er
toothy	tooth - y
washing	wash - ing
confessing	confess - ing
spots	s - pot - s
quasi-instinctive	quasi-instinctiv - e
stage	stage
rang	rang
purpose	purpose
starting-point	starting-point
certain	certain
founded	found - ed
hypocrites	hypocrite - s
curses	cur - s - es
provinces	province - s
scrimmage	scrimmage
reception	reception
fuss	fuss
annihilating	annihilat - ing
gate	gate
insane	in - sane
reshape	re - shape
estimates	estimate - s
intelligent	intelligent
soldier	soldier
fretfully	f - retful - ly
chestnut	chestnut
appreciation	appreciat - ion
delightedly	delight - ed - ly
heavier	heavier
pleasures	pleasure - s
cluster	c - lust - er
tip	tip
breadcrusts	breadcrust - s
alert	al - ert
reflect	reflect
useless	useless
resettling	resettl - ing
rulership	rulership
engaging	engag - ing
governments	government - s
mystically	mystical - ly
venomous	venomou - s
rectified	rectifi - ed
statistical	statistic - al
scenery	s - cenery
bolts	bolts
drugs	drugs
across	a - cross
fling	fling
oppression	oppress - ion
sang	s - ang
agonizing	agonizing
gracefully	grace - ful - ly
man-eaters	man-eaters
arts	art - s
mentally	mental - ly
relief	relief
submission	submission
understanding	understand - ing
beginnings	beginn - ing - s
baize	baize
casualties	casualti - e - s
filth	filth
fortunately	fortunately
friendly	friend - ly
helped	help - ed
literature	literature
dealt	dealt
pasting	past - ing
conquests	conquest - s
disregarded	dis - regard - ed
know	know
humility	humility
mistakes	mistake - s
passionately	passionate - ly
pinkish	pinkish
producing	produc - ing
pardon	pardon
pay	p - ay
day-to-day	day-to-day
profound	profound
regenerate	re - generate
loves	love - s
supplemented	supplement - ed
wide-open	wide-open
spot	s - pot
extorted	extort - ed
anti-sex	anti-sex
fact	f - act
posted	post - ed
scream	scream
inferiority	inferior - ity
spit	s - p - it
tucked	tuck - ed
sent	sent
dispensed	dispens - ed
boyhood	boyhood
embellishing	embellish - ing
fundamental	fundamental
hurriedly	hurried - ly
immovably	immovably
necessity	necessit - y
ossified	ossified
alcohol	alcohol
delightful	delight - ful
sawing	s - a - wing
stories	stor - ies
medical	medical
difference	difference
enlightenment	enlighten - ment
eyelids	eyelid - s
imitation	imitat - ion
vindicate	vindicate
locked	lock - ed
neckerchief	neckerchief
soft	soft
hinges	hinges
banged	b - ang - ed
cheekbones	cheekbone - s
reject	reject
hard	hard
tough-looking	tough-looking
hating	hating
leave	leav - e
needed	need - ed
death-worship	death-worship
invertebrate	invertebrate
graduate	graduat - e
conversion	con - version
frowsy	frowsy
prints	print - s
teachers	teach - er - s
wireless	wirele - s - s
communists	communist - s
manipulated	manipulate - d
indicated	indicat - ed
predominated	p - re - dominat - ed
improper	im - proper
cancel	cancel
inquisition	inquisit - ion
shorts	short - s
forward	forward
charrington	charrington
cooked	cook - ed
sleeves	sleeves
talks	talk - s
upsub	upsub
diaphragm	diaphragm
'yenas	'yenas
depths	depth - s
build	build
well-packed	well-pack - ed
membership	membership
disciplined	discipline - d
perish	perish
neat	n - eat
definite	definite
hand-grenade	hand-grenad - e
poisons	poison - s
force	forc - e
carelessness	careless - ness
downhearted	downheart - ed
stormed	storm - ed
new	new
feelings	feel - ing - s
had	had
forbearance	forbearance
contortions	contort - ion - s
persuading	persuad - ing
tell	tell
we	we
borrowed	borrow - ed
privations	privation - s
promise	promis - e
'opeless	'opeless
tenses	tense - s
dark-red	dark-r - ed
silky	silk - y
world	world
oligarchy	oligarch - y
near	near
collectivism	collectiv - ism
doctrines	doctrine - s
project	project
convulsion	convul - s - ion
below	be - low
rallies	ralli - e - s
thundering	thunder - ing
recovery	re - cover - y
lost	lost
thinked	think - ed
snowdrift	s - nowdrift
arose	a - rose
painful	pain - ful
widened	wide - n - ed
wainscoting	wainscot - ing
reg'lar	reg'lar
barking	bark - ing
continually	continu - ally
advantage	advantage
candle	candle
half	half
occasions	occasion - s
rubbish	rubb - ish
seventy	s - event - y
skeleton	skeleton
mans	man - s
unbroken	un - broken
baulks	baulks
stimulus	stimulus
woods	wood - s
quadrilateral	quadrilateral
decide	decid - e
displayed	dis - play - ed
avoiding	avoid - ing
baldly	bald - ly
cattle	cattle
folded	fold - ed
forties	forties
needing	need - ing
overt	overt
hovered	hover - ed
truths	truth - s
cherished	cherish - ed
uneasiness	uneasine - s - s
villages	village - s
keepsake	keepsake
begetting	be - getting
boot	boot
affixes	affix - e - s
dragged	dragg - ed
inscribed	inscribed
bellowed	bellowed
copies	copi - e - s
judged	judg - ed
translation	translat - ion
repainted	re - paint - ed
travelled	travelled
cyclical	cyclical
quite	quite
developing	develop - ing
adherents	adherents
shedding	s - hedd - ing
unendurable	un - endurable
hazel	hazel
surrender	surrender
coincide	coincid - e
fiercely	fierce - ly
horizon	horizon
supple	supple
warmer	warm - er
total	total
covers	cover - s
backyard	backyard
eaten	eat - en
herself	herself
nonsmoker	nonsmoker
exile	exile
renewal	re - new - al
evenings	even - ing - s
kissed	kiss - ed
utterance	utter - ance
better	better
mahogany	mahogany
hauling	hauling
whereabouts	whereabout - s
decay	decay
despise	despise
grille	grille
heels	heel - s
catechism	catechism
nation	nation
background	background
ceased	cease - d
rabbit-cropped	rabbit-cropped
momentary	moment - ary
dares	dare - s
chronic	chronic
first-rate	first-rate
friendships	friendship - s
slits	s - lit - s
hiking	hiking
risen	rise - n
untruthfully	un - truthful - ly
top	top
unaware	un - aware
clicked	click - ed
emaciation	emaciation
toiling	toil - ing
fought	f - ought
divined	divined
subdued	subdued
bombed	bomb - ed
post	post
sprang	s - p - rang
centre	centre
visualized	visualiz - ed
transmit	transmit
clang	clang
paces	pace - s
;	;
non-existent	non-existent
mastered	master - ed
continued	continu - ed
joining	join - ing
ordered	order - ed
ours	our - s
saboteurs	saboteurs
sack	sack
staggering	staggering
control	control
disagreeable	dis - agree - able
vigour	vigour
showing	show - ing
piece	piece
ma	ma
march	march
'ere	'er - e
tinking	tink - ing
results	result - s
several	s - ever - al
depended	depend - ed
bubble	bubble
culpable	culpabl - e
frantic	frantic
occur	occur
priests	priest - s
decorated	decorat - ed
joycamp	joycamp
relaxations	relaxation - s
sobbed	sobbed
screwed-up	screwed-up
both	both
cloudless	cloud - less
minitrue	minitru - e
petty	pett - y
workshop	workshop
agent	a - gent
undirected	un - direct - ed
ignorant	ignorant
remembers	remember - s
exercising	exercis - ing
tread	tread
relating	relat - ing
yells	yell - s
alarmed	al - arm - ed
ideological	ideological
thought	thought
implied	implied
loathed	loath - ed
white-jacketed	white-jacketed
stuffy	stuff - y
coils	c - oil - s
fool	f - ool
tear	tear
tom-toms	tom-tom - s
entertainment	entertain - ment
b	b
dug	dug
joy	joy
sunburnt	s - un - burnt
well-nigh	well-nigh
fossil	f - ossil
head	head
dome	dome
fixed	fix - ed
sets	s - et - s
swallow	swallow
heretical	heretic - al
creases	creas - e - s
intimates	intimate - s
expanded	expanded
chopper	chopper
burnt	burnt
1983	1983
blocked	block - ed
enlightened	enlighten - ed
echoed	echoe - d
leaked	leak - ed
hurriedly-whispered	hurriedly-whispered
hostility	hostil - ity
impression	impress - ion
entry	entry
acceptable	accept - able
graceful	grace - ful
interrogated	interrogat - ed
numbering	number - ing
speckled	speckled
presented	present - ed
imitating	imitat - ing
incredibly	in - credibly
pattern	pattern
exhausting	exhaust - ing
rises	rise - s
deepest	deep - est
abreast	a - breast
sailing-ship	sailing-ship
aberrations	aberration - s
obliteration	obliteration
weeds	weeds
caused	caus - ed
shrill	shrill
thoughtless	thought - less
legible	legible
rubble	rubble
equation	equat - ion
mysticism	mysticism
nine	nin - e
highly-paid	highly-paid
causing	caus - ing
despotisms	despotism - s
three-sided	three-sided
games	game - s
meal	meal
acceptance	accept - ance
nightly	night - ly
teleprogrammes	teleprogrammes
edition	edition
frontier	frontier
avoid	avoid
scribbling	scribbl - ing
self-abasement	self-abase - ment
thus	thus
distribute	distribut - e
end	end
quiver	quiver
rays	ray - s
unfamiliar	un - familiar
pillowed	pillow - ed
dollars	dollars
luckily	luckily
philologist	philologist
valiant	valiant
account	account
ray	ray
willing	willing
check	check
heresies	heresies
formality	formal - ity
slogans	slogan - s
dented	dent - ed
rockets	rocket - s
inconceivably	in - conceivably
perception	perception
supposing	suppos - ing
well	well
afflicted	afflicted
style	style
motionless	motion - less
banding	band - ing
displacing	dis - plac - ing
prelude	prelude
warfare	warfare
aren't	aren't
shying	s - hying
weeping	weep - ing
lesson	lesson
grenade	grenade
posterior	posterior
ago	a - go
assert	assert
attempting	attempt - ing
brighter	b - right - er
brother	br - other
dose	do - s - e
pope	pope
quacking	quack - ing
sight	sight
'd	'd
suggest	suggest
thrust	thrust
failure	failure
particular	particular
to	to
tripped	tripp - ed
ice-cap	ice-cap
caf	caf
clandestinely	clandestinely
arithmetic	arithmetic
bearded	bear - d - ed
majority	majority
wheeled	wheel - ed
elbow	elbow
doubleplus	doubleplus
now-existing	now-exist - ing
rolled	roll - ed
june	jun - e
wrong	wrong
undark	un - dark
cubs	cub - s
stem	stem
thought-criminals	thought-criminal - s
astonishing	astonish - ing
whizzing	whizz - ing
literally	literally
bewilderment	bewilderment
furtive	furtive
content	content
euphony	euphony
cascaded	cascaded
writhing	writh - ing
what	what
athletic	athletic
cheating	cheat - ing
keen	keen
wandering	wander - ing
particularly	particular - ly
160	160
shouting	shout - ing
deranged	deranged
incompetence	in - compet - ence
conspiracies	conspirac - ies
organizations	organization - s
tendency	tendenc - y
hardened	harden - ed
reverse	revers - e
mildly	mild - ly
neckerchiefs	neckerchief - s
erases	erase - s
reverting	revert - ing
blinding	blind - ing
long-dead	long-dead
talent	talent
1944	1944
afternoon	afternoon
goodthink	goodthink
hoping	hoping
squad	squad
squeaking	squeak - ing
undertaken	undertaken
cake	c - ake
am	am
furnaces	furnaces
keeping	keep - ing
smith	s - mith
astray	a - s - tray
phrase	phrase
softer	soft - er
underheated	underheat - ed
worry	worry
blood	blood
famous	famous
magnitude	magnitude
cabbage-stalk	cabbage-stalk
thigh-bones	thigh-bone - s
hint	hint
creator	creat - or
walked	walk - ed
mother	mother
hairy	h - air - y
hook-nosed	hook-nosed
address	addres - s
recreations	recreation - s
thirty-six	thirty-six
majesty	majesty
wields	wield - s
pressure	pressure
around	a - round
gooder	good - er
grown	grow - n
driving	driv - ing
cramp	cramp
plusfull	plusfull
wives	wives
literate	literate
malleable	malleable
air	air
handleless	handle - less
shins	shin - s
gasps	gasp - s
irrelevant	ir - relevant
comparing	compar - ing
limited	limit - ed
movable	movable
pausing	paus - ing
agents	a - gent - s
society	society
cheerful	cheer - ful
throw	throw
counter	count - er
youngish	young - ish
fragments	fragment - s
tempted	tempt - ed
forcible	forcible
deriving	deriv - ing
round	round
dived	dived
grumbled	grumbled
intimate	intimate
brim	brim
twenty-thirty	twenty-thirty
term	term
allows	allow - s
fury	fur - y
heard	hear - d
grating	grating
re-focused	re- - focus - ed
temptation	temptation
boiling	boil - ing
visible	visible
fields	field - s
slowed	s - low - ed
beings	being - s
exterminate	exterminate
weather	weather
bushes	bushes
highest	high - est
gestures	gesture - s
posterity	poster - ity
trivial	trivial
lighthouse	lighthous - e
crying	crying
love	love
unthinkable	un - think - able
language	language
output	output
nuzzled	nuzzled
plurals	plurals
list	list
intense	in - tense
mutters	mutter - s
so-called	s - o-call - ed
shock	shock
fraternity	fraternity
honesty	honest - y
impulse	impulse
govern	govern
novel-writing	novel-writ - ing
hen	hen
scrabbling	scrabbling
repelled	re - p - ell - ed
goodthinkful	goodthink - ful
slaughters	s - laughter - s
barber	barber
date	dat - e
paradise	paradise
saving	saving
silly-faced	s - illy-fac - ed
worn	worn
emptiness	empti - ness
stumping	stump - ing
trade	trade
model	model
chased	chas - ed
presumably	p - resumably
bare	b - are
cold-faced	cold-fac - ed
didn't	didn't
right-hand	right-hand
ringing	ring - ing
advocated	advocat - ed
fade	fade
connected	connected
who	who
prematurely	prematurely
speciality	s - pecial - ity
doubled	doubl - ed
conversational	conversation - al
procreation	procreat - ion
1945	1945
confessed	confess - ed
haranguing	haranguing
painfully	pain - ful - ly
spent	s - pent
wallowing	wallowing
orthodoxy	orthodox - y
setting	s - etting
darkest	dark - est
somewhere	somewhere
writings	writing - s
equator	equator
forty	fort - y
soldiers	soldier - s
cannot	cannot
inflexions	in - flexion - s
chinese	chines - e
essence	essence
certainly	certain - ly
here	her - e
aureole	aureole
five-and-thirty	five-and-thirty
aching	aching
mechanization	mechanization
crystal	crystal
overwhelmed	overwhelm - ed
unrolling	un - roll - ing
work	work
pass	pass
rose	rose
kindred	kindr - ed
liberty	liberty
an'	an'
chemist	chemist
familiarize	familiarize
items	item - s
meaningless	meaning - less
fanatically	fanatic - ally
varied	varie - d
wading	wading
lovely	love - ly
regard	regard
published	p - ublish - ed
remove	re - move
stayed	stay - ed
dimmest	dimm - est
indiscretion	in - discretion
spirit	spirit
turmoil	turmoil
luck	luck
unresisting	un - resist - ing
fate	fat - e
holiday	holiday
leader-worship	leader-worship
impalement	impalement
tinny	tinny
movement	movement
things	thing - s
embraces	embrace - s
independent	in - dependent
nineteenth-century	nineteenth-century
pang	p - ang
scattered	s - c - atter - ed
theirs	their - s
murmur	murmur
pages	p - age - s
ampleforth	ampleforth
judge	judg - e
rearrange	re - arrang - e
rode	rod - e
dimensions	dimension - s
spurts	s - purt - s
bread	b - read
bruised	bruis - ed
farthing	farthing
chain	chain
immobile	im - mobile
shooting	shoot - ing
your	your
succeed	succeed
'ow	'ow
noticeable	notic - e - able
fish	fish
bone	b - one
paralysed	paraly - s - ed
saucepan	saucepan
carpeted	carpet - ed
pursuit	pursuit
treatise	treatise
reintegration	reintegration
such-like	such-like
some	some
decade	decade
voicing	voic - ing
disgust	disgust
overalls	overalls
house	house
means	mean - s
bathroom	bathroom
echoes	echoe - s
body	b - od - y
clock	c - lock
laughing	laugh - ing
smoothed	s - mooth - ed
textbook	textbook
stable	s - table
last	last
success	success
nights	night - s
chosen	chosen
state	state
lanes	lane - s
possessions	possession - s
bases	base - s
lot	lot
angle	angle
glad	glad
reveries	reverie - s
ideas	idea - s
facial	facial
nicknames	nickname - s
slaughter	s - laughter
spongy	spongy
biggest	biggest
compliment	compliment
reach	reach
lucky	luck - y
best	b - est
dead	dead
signed	sign - ed
marriage	marriage
carrying	carry - ing
grow	grow
foolish	foolish
embedded	embedd - ed
adultery	adult - er - y
lifeboat	lifeboat
column	column
chewed	chewed
hungry	h - ungry
fluctuate	fluctuat - e
chin	chin
jacket	jacket
motion	motion
fretted	fretted
martyrs	martyrs
noises	noise - s
fiction	fict - ion
powdery	powder - y
saloon	s - aloon
flowing	flow - ing
advances	advanc - e - s
brushed	b - rush - ed
colour	colour
doubleplusungood	doubleplusungood
gambolling	gamboll - ing
grimy	grim - y
constituted	constituted
communication	communicat - ion
her	her
tremor	tremor
favouritism	favourit - ism
proud	proud
engraving	engraving
jelly	jelly
identifiable	identifi - able
light-years	light-years
barefooted	barefoot - ed
spurious	spurious
pause	paus - e
same	s - am - e
delude	delude
leather-covered	leather-covered
evil-smelling	evil-smell - ing
rough	rough
accomplices	accomplices
stale	s - tale
criminal	criminal
metal-topped	metal-topped
worthy	worth - y
illustrating	illustrat - ing
comfort	comfort
tarnished	tarnished
unit	unit
disgrace	dis - grace
wriggle	wriggle
people	people
four	four
brains	brain - s
orator	orator
unorthodoxy	un - orthodox - y
projectiles	projectile - s
got	got
speaker	speak - er
newspapers	newspaper - s
tormentor	torment - or
unreal	un - real
falsifying	falsifying
spilt	spilt
separation	separat - ion
inspired	inspired
calculations	calculat - ion - s
clasp	clasp
earliest	earli - est
projects	project - s
disappearing	disappear - ing
safe	s - afe
grandmother	grand - mother
later	later
fall	f - all
solves	solve - s
impatient	im - patient
summons	summon - s
inefficiently	in - efficient - ly
misprinted	misprint - ed
unexpected	un - expect - ed
tense	tense
compendium	compendium
needs	need - s
unproceed	un - proceed
separately	separat - e - ly
trying	trying
scarlet-draped	s - carlet-drape - d
britain	britain
injury	injur - y
appealing	appeal - ing
books	book - s
zeal	zeal
plaster	plaster
receiving	receiv - ing
filthily	filthily
morale	moral - e
reading	read - ing
associations	association - s
difficulty	difficult - y
toe	to - e
dark-chinned	dark-chinned
caesar	caesar
bloodthirsty	bloodthirsty
drugged	drugged
embezzlement	embezzlement
failing	fail - ing
persecutors	persecut - or - s
shade	shade
passionate	passionate
stickiness	stickiness
volume	volume
indefatigable	in - defatigabl - e
old	old
pieces	piece - s
spaciousness	spaciousness
carry	carry
takes	take - s
meetings	meet - ing - s
all-important	all- - important
opposition	opposition
blot	b - lot
dribbled	dribble - d
hordes	horde - s
knew	knew
paragraph	paragraph
represent	re - present
sideways	sideways
vile	vile
wearing	wear - ing
lords	lord - s
treetops	treetop - s
spotted	spott - ed
edge	edge
knee	knee
advantages	advantage - s
haricot	haricot
hundreds	hundred - s
regimentation	regimentation
java	java
predicted	predict - ed
guilt	guilt
situations	situation - s
speed	speed
stations	station - s
child	child
theory	theory
tribe	tribe
truly	truly
unexplored	un - explore - d
hated	hat - ed
yours	your - s
-	-
wax	wax
anew	a - new
ones	one - s
prevent	prevent
self-possession	self- - possession
grass-grown	grass-grown
need	need
pornography	pornography
adverb	adverb
neo-bolshevism	neo-bolshevism
whistle	whistle
beginning	beginn - ing
distinctly	distinct - ly
enterprise	enterprise
catholics	catholic - s
gabble	gabbl - e
unrolled	unroll - ed
twentyfour	twentyfour
corridors	corridor - s
bade	bad - e
skull-faced	skull-faced
bowed	bow - ed
prominent	prominent
sex	sex
therapy	therapy
collated	c - ollated
steeple	steeple
timorously	timorously
violated	violate - d
recalled	re - call - ed
ermine	ermine
perfect	perfect
waist	waist
childhood	childhood
flickering	flicker - ing
continues	continu - e - s
horn	horn
spend	s - p - end
anemone	anemone
concertina-like	con - certina-like
distinguishable	distinguish - able
fluid	fluid
prevented	prevent - ed
partial	partial
willows	willow - s
full-sized	full-sized
greenish	green - ish
aiming	aiming
airfield	airfield
achieving	achiev - ing
asiatic	asiatic
biologists	biologist - s
fifty-seven	fifty-seven
pipes	pipe - s
rounder	round - er
proliferated	proliferat - ed
criminals	criminal - s
places	plac - e - s
smash	smash
lay-figure	lay-figur - e
nostrils	nostrils
revealing	revealing
precise-looking	precise-looking
absent-minded	absent-minded
dodge	dodge
fond	f - ond
whiffs	whiff - s
earth	earth
graves	grav - e - s
ruffians	ruffian - s
infected	infect - ed
falsity	falsity
joyless	joyless
not	not
nothing	nothing
exercises	exercis - e - s
doorway	doorway
floating	float - ing
shortage	shortage
fellow-employee	fellow-employ - e - e
streak	streak
something	something
sunday	s - un - day
hurtling	hurtl - ing
sye	s - ye
continuously	continuous - ly
relative	relat - ive
or	or
tortures	torture - s
board	board
badness	b - adness
hadn't	hadn't
embarrassment	embarrass - ment
goodthinkwise	goodthink - wise
winked	wink - ed
soundless	soundless
laborious	laboriou - s
series	serie - s
contrary	contrary
wooden	wood - en
enthusiasm	enthusiasm
touched	touch - ed
cliff	cliff
airstrip	airstrip
undigested	undigested
compromise	compromis - e
wearily	weari - ly
scaly	s - caly
fulminating	f - ulminating
neither	n - either
extension	extension
pyramids	pyramid - s
shocking	shock - ing
tower	tower
abruptly	abruptly
available	available
choked	c - hoked
crimestop	crimestop
leaves	leav - e - s
siberia	siberia
mournfully	mournful - ly
defection	defect - ion
constructed	construct - ed
helicopter	helicopter
alteration	alter - at - ion
spirals	spiral - s
stair	stair
batteries	batter - ies
cases	case - s
covered	cover - ed
dizzy	dizzy
fuller	full - er
improvising	improvis - ing
none	n - one
politicals	political - s
accuracy	accuracy
reality	real - ity
sustain	sustain
wondering	wonder - ing
adjectival	adjectival
bitterness	b - itterness
entanglements	entanglements
redivision	redivis - ion
trailing	trailing
solved	solved
homeless	homeless
dental	dental
scorched	s - corched
tracks	track - s
dappled	dappled
connotation	connotation
part-time	part-time
loitering	loiter - ing
glittering	glitter - ing
st	st
trampling	trampl - ing
sensitivity	sensitivity
thickened	thick - en - ed
mines	mine - s
rippled	rippled
soothing	sooth - ing
peelings	peeling - s
evening	even - ing
violate	violate
copy	copy
lying	lying
wailed	wail - ed
shows	show - s
demand	demand
leather	leather
fifty-five	fifty-five
milkless	milkless
entertained	entertain - ed
irony	iron - y
luxuries	luxuries
rock	rock
undermine	undermine
leap	leap
surprised	s - urpris - ed
outburst	out - burst
silently	silent - ly
occasion	occasion
1968	1968
space	s - pace
faces	face - s
stolen	stolen
standing	stand - ing
despised	despise - d
broader	broader
hopped	hopp - ed
luxuriously	luxurious - ly
filling	fill - ing
instructions	instruction - s
interrupted	interrupt - ed
unformed	un - form - ed
rot	rot
unconsciousness	un - consciou - s - ness
unexampled	un - example - d
landscape	landscape
triumphant	triumphant
fly	fly
drunks	drunk - s
fourteen-thirty	fourteen-thirty
infer	in - fer
broad-chested	broad-chested
transfer	transfer
blubbering	blubber - ing
foreign	foreign
spraying	s - pray - ing
voluptuously	voluptuous - ly
sworn	s - worn
section	sect - ion
railway	railway
goldstein	goldstein
renegade	renegade
reopen	re - open
towered	tower - ed
heresy	heresy
subjected	subject - ed
thinkers	think - er - s
iron	iron
famine	f - a - mine
hunger	hung - er
examine	examin - e
'a	'a
interrogation	interrogat - ion
stagnate	s - tagnate
wiping-out	wiping-out
forth	forth
fashion	fashion
fancy	fancy
bottom	bottom
lavatories	lavatories
beaten	beat - en
unlight	un - light
amends	a - mend - s
bluebottle	blue - bottle
colours	colour - s
loss	los - s
peoples	people - s
induced	induc - ed
league	leagu - e
cooking-pots	cooking-pot - s
simultaneously	simultaneou - s - ly
pierced	pierc - ed
itching	itch - ing
refuted	re - fut - ed
somebody	somebody
treaties	treatie - s
dusted	dust - ed
spoils	spoil - s
authentically	authentically
licked	licked
doubtfully	doubtful - ly
fifth	fifth
governed	govern - ed
stool	stool
unborn	un - born
all-powerful	all- - power - ful
sunlit	s - un - lit
code	c - od - e
learned	learn - ed
cross-referencing	cross-referencing
recurring	recurr - ing
shuddered	shudder - ed
square	square
slatternly	slatternly
funds	fund - s
matters	matter - s
tooth	tooth
adulteries	adult - er - ies
bite	b - it - e
driveling	driveling
integrity	integrity
plainly	p - lain - ly
trained	train - ed
embodiment	embodi - ment
war-fever	war-fever
bloom	bloom
existed	exist - ed
including	includ - ing
peeped	peep - ed
speculatively	speculative - ly
conscious	consciou - s
fearless	fearless
inform	in - form
weighed	weighed
frontiers	frontier - s
embodied	embodi - ed
succession	success - ion
soil	s - oil
amersham	a - mersham
ethical	ethical
predicament	predicament
economies	economies
swished	s - wished
bounced	b - ounce - d
skeleton-like	s - keleton - -like
presently	present - ly
genuinely	genuine - ly
crown	crown
heritage	heritage
nosing	nosing
voluntarily	voluntarily
chicken-houses	c - hicken-houses
grows	grow - s
spray	s - pray
confident	confident
small	small
tank	tank
proclaimed	proclaim - ed
germany	german - y
noisy	noisy
tom	tom
minimum	minimum
street	street
thigh	thigh
invention	invent - ion
dispersed	dis - persed
impoverishment	impoverishment
describing	describ - ing
grouped	group - ed
kids	kid - s
prejudice	prejudic - e
narrow	narrow
april	april
deceived	deceiv - ed
vegetable	vegetable
erased	erase - d
theoretical	theoretical
so	so
pretext	pretext
repaired	re - pair - ed
seaborne	s - eaborne
unpunished	un - punish - ed
jointly	joint - ly
unwholesome	unwholesome
awkward	awkward
part	part
waxworks	waxwork - s
penetrated	penetrat - ed
tone	tone
batter	batter
motor	motor
measures	measur - es
possibility	possibilit - y
encounter	encounter
isn't	isn't
nonsense	nonsense
branches	branch - e - s
faintest	faint - est
religion	religion
disentangled	dis - entangl - ed
squirmed	squirmed
explained	explain - ed
hidden	hidden
bold-looking	bold-look - ing
speeches	speeches
wound	wound
say	s - ay
wonder	wonder
rejected	reject - ed
beg	beg
bowels	bowel - s
yell	yell
teacup	teacup
politicians	politicians
crime	crime
necessary	necessary
metres	metre - s
saucepans	saucepan - s
inimical	inimical
spoonfuls	spoon - ful - s
faced	face - d
darning	darning
tiddly-winks	tiddly-wink - s
ruin	ruin
zipper	zipper
obscene	obscene
picture-frames	picture-frame - s
observers	observ - er - s
sweat	sweat
material	material
haven't	haven't
scientists	scientist - s
everything	everything
mysteriously	mysteriou - s - ly
their	their
kiss	kiss
threaten	threaten
ferocity	ferocity
bombs	bomb - s
statistics	statistic - s
squeak	squeak
bookcase	bookcase
cubicles	cubicle - s
ashes	ashes
correct	correct
portrait	portrait
constructionwise	construction - wise
rarity	rarity
perverse	pervers - e
defiler	defiler
weak	weak
vapour	vapour
evaporate	evaporate
doublethink	doublethink
expressing	express - ing
exchange	exchange
boat	boat
prophecies	propheci - e - s
imprisonment	imprisonment
indifference	in - difference
openly	open - ly
solipsism	s - olipsism
violent	violent
enforcing	en - forc - ing
ethics	ethics
trickling	trickl - ing
starved	starv - ed
basin	basin
written	written
summon	summon
truthfulness	truthful - ness
half-apprehensive	half-apprehensive
broke	broke
clamorous	clamorou - s
night	night
aged	age - d
forsook	forsook
briskly	b - risk - ly
wordless	wordless
i	i
battles	battle - s
neutralize	neutralize
pelting	p - elting
specialized	s - pecial - ized
position	position
adjective	adjective
adoption	adopt - ion
curvature	curvature
oil	oil
rodent	rodent
wanted	want - ed
stopping	stopp - ing
zealous	zealous
remedied	remedied
untrue	un - true
interested	interest - ed
training	train - ing
patriotic	patriotic
enlist	en - list
fabulous	fabulous
foreshortening	foreshorten - ing
neurotically	neuroticall - y
rumours	rumour - s
intercourse	inter - course
contradiction	contradict - ion
social	social
annual	annual
department	department
wrists	wrist - s
metre	metre
honestly	honest - ly
imperturbable	imperturbable
reasonably	reason - ably
sententiously	s - en - tentious - ly
unreproved	un - re - prov - ed
consent	con - sent
holder	holder
bed	b - ed
arise	a - rise
popular	popular
shouts	shout - s
relevance	relevance
unattended	un - attend - ed
dearie	dearie
accounted	account - ed
illicit	illicit
theyll	theyll
held	held
trim	trim
kept	kept
broken	broken
cracks	crack - s
territory	territor - y
given	give - n
roaring	roar - ing
fresh	fresh
conceivably	conceivably
recurrence	recurr - ence
signatures	signatures
uncertain	un - certain
deception	deception
developments	develop - ment - s
safety	safet - y
wolfed	wolf - ed
for	f - or
drained	drained
birth	birth
fro	fro
o	o
rob	rob
affection	affect - ion
fastened	fasten - ed
knows	know - s
proof	p - roof
visiting	visit - ing
porpoise	p - orpoise
tired-looking	tired-look - ing
buried	buri - ed
anywhere	anywhere
big	big
franca	franca
repairs	re - p - air - s
cramped	cramp - ed
discuss	discus - s
addressing	addres - s - ing
diminish	diminish
australasia	australasia
'em	'em
returns	re - turn - s
orthodox	orthodox
struggle	struggl - e
error	error
papier-mch	papier-mch
produced	produc - ed
lyric	lyric
shameless	s - hameless
announce	announce
situation	situation
tenements	tenements
width	width
economy	economy
swinging	s - wing - ing
have	have
meditations	meditat - ion - s
leisured	leisure - d
liberal	liberal
husband	husband
bombing	bomb - ing
boldly	b - old - ly
penitence	penitence
seem	seem
tenderness	tendernes - s
undifferentiated	un - differentiat - ed
departure	departure
increased	increase - d
rout	rout
tale	tale
ficdep	ficdep
puzzled	puzzle - d
milton	milton
pointed	point - ed
unspoken	un - spoken
lines	line - s
prawn	prawn
listlessness	listless - ness
compounded	compound - ed
malquoted	malquoted
noticeably	notic - e - ably
traffic	traffic
entering	enter - ing
shakespeare	s - hakespear - e
mongolian	mongolia - n
insanity	in - s - anity
roof	roof
staff	staff
splitting-off	splitting-off
arm-chair	arm-chair
beneath	beneath
awoke	a - woke
shrank	s - h - rank
scars	s - car - s
emphasis	emphasi - s
row	row
salaried	s - alaried
yielded	yield - ed
likes	like - s
skull	skull
powerful	power - ful
honour	honour
increases	increase - s
cigarettes	cigarette - s
recurrent	re - current
symptoms	symptom - s
individually	individual - ly
symptom	symptom
powdered	powder - ed
're	're
knock	knock
agreeing	agree - ing
never-broken	never-broken
woman	woman
exerted	exert - ed
flapped	f - lapped
calmer	calm - er
groans	groan - s
outstanding	out - stand - ing
scrawl	s - crawl
establish	establish
mutually	mutually
formulated	formulate - d
sit	s - it
bedhead	bedhead
deafening	deafen - ing
dont	dont
lamplight	lamplight
slummy	slummy
millimetre	millimetr - e
special	s - pecial
wheels	wheel - s
define	defin - e
torrent	torrent
whipped	whipped
pour	pour
catholic	catholic
definitive	definitive
followers	follow - er - s
dependent	dependent
twisted	twist - ed
pencil	pencil
bladder	b - ladder
chalk	chalk
purely	pure - ly
foreigner	foreign - er
scrape	scrap - e
courts	court - s
admirer	admir - er
digression	digression
fits	fits
whereas	whereas
resisting	resist - ing
hovering	hover - ing
'ome	'ome
halves	halves
banners	banner - s
doubting	doubt - ing
girls	girl - s
'ear	'ear
cubes	cube - s
socks	sock - s
flats	flat - s
invincible	invincible
says	s - ay - s
eating	eating
titles	title - s
today	today
hullo	hullo
dragging	dragg - ing
humiliation	humiliat - ion
defining	defin - ing
divided	divid - ed
back-street	back-street
medley	medley
preoccupy	p - re - occupy
trust	trust
groan	groan
sub-machine	sub- - machine
suddenly	sudden - ly
pain	pain
knowledge	knowledge
weariness	weari - ness
becoming	becom - ing
themes	them - e - s
evidently	evident - ly
community	commun - ity
memorized	memoriz - e - d
lean	lean
sea	s - ea
exhaustive	exhaust - ive
solely	sole - ly
censored	censor - ed
elimination	eliminat - ion
voices	voic - e - s
kilometres	kilometre - s
placed	plac - e - d
interchange	inter - change
euphemisms	euphemism - s
frozen	froze - n
uttering	utter - ing
thundered	thunder - ed
nineteen-forties	nineteen-fortie - s
till	till
tricky	trick - y
sexes	sex - e - s
doctor	doctor
outfit	outfit
burn	burn
shuffling	shuffl - ing
rails	rail - s
warning	warn - ing
invariable	invariabl - e
box	b - ox
imposed	impos - ed
iniquity	in - iquity
patrols	patrol - s
nex'	nex'
nobility	nobility
shutting	shutt - ing
drama	drama
derided	derided
'll	'll
machine-gun	machine-gun
seamed	s - eam - ed
executed	execut - ed
attentive	attentive
upstairs	upstair - s
corpse	corpse
