practised	practised
follow	follow
bricks	bricks
annually	annual - ly
canada	canada
emmanuel	emmanuel
foolery	foolery
expert	expert
relation	relat - ion
formal	form - al
answered	answer - ed
roved	roved
directories	directorie - s
chances	chanc - e - s
of	of
cruelly	cruel - ly
detection	detect - ion
strokes	stroke - s
treasurer	treasurer
typography	typography
yourself	yourself
aprons	apron - s
khaki	khaki
backward	backward
frightening	frighten - ing
intimately	intimate - ly
wounds	wound - s
obscure	obscure
thighs	t - high - s
reasoning	reason - ing
nobleman	nobleman
opponent	opponent
manipulate	manipulate
resemble	re - semble
ambivalent	ambivalent
orgiastic	orgiastic
tapped	tapp - ed
interim	in - terim
lions	lion - s
highly-trained	highly-trained
riotous	riotous
goatee	goat - e - e
familiar	familiar
habit	habit
leaky	leak - y
dutifully	dutiful - ly
mentioned	mention - ed
senile	s - enile
floated	float - ed
pulling	pull - ing
gaze	gaze
perpetually	perpetual - ly
pockets	pocket - s
un	un
jews	jews
appearance	appearance
forced	forc - ed
horde	horde
objection	object - ion
surprisingly	s - urpris - ing - ly
limit	limit
recdep	recdep
health	health
oldthinkers	oldthink - er - s
record	record
pick-axe	pick-axe
dumb	dumb
splayed	s - play - ed
striking	strik - ing
tenth	tenth
sunshine	s - un - shin - e
cloudy	cloud - y
disguised	dis - guis - ed
plausibly	plausibl - y
regions	region - s
thoroughness	thorough - ness
painless	painless
bung	b - ung
lessened	lessen - ed
relics	re - lics
attraction	attract - ion
dates	date - s
road	road
bakeries	bakerie - s
cardboard	cardboard
urge	urge
lumped	lump - ed
underneath	un - d - erneath
allowed	allow - ed
guardian	guardian
gather	gather
memoranda	memoranda
19.12.83	19.12.83
pores	p - ore - s
scarcity	scarcity
suddenness	sudden - ness
pitiful	pitiful
roughly	rough - ly
subordinate	subordinate
took	took
equality	equality
straightening	straighten - ing
attain	a - t - tain
diapers	diaper - s
sleep	sleep
penholder	penholder
doleful	doleful
doublepluscold	doubleplus - cold
quackquack-quacking	quackquack-quacking
cured	cur - ed
cleaned	c - lean - ed
rapid	rapid
educate	educat - e
ahead	a - head
close	clos - e
emerge	emerge
revolutionary	revolutionary
forgot	forgot
amount	amount
etymologically	etymological - ly
instinct	instinct
dreaming	dream - ing
masses	mass - e - s
plaque	plaque
powerless	power - less
reptiles	re - ptiles
lunatic	lunatic
poems	poem - s
forgeries	forger - ies
pierce	pierc - e
injured	injur - ed
scepticism	scepticism
securing	secur - ing
truth	truth
leg-irons	leg-irons
having	h - aving
willow-herb	willow-herb
catching	catching
feats	f - eat - s
plenty	plenty
vindictiveness	vindictivene - s - s
quarter	quart - er
outwit	outwit
youths	youth - s
understand	understand
formerly	former - ly
straightened	straighten - ed
grace	grace
drivelling	drivelling
help	help
rapped	rapped
secured	secur - ed
cow	c - ow
hard-working	hard-work - ing
mats	m - at - s
dog-eared	dog-eared
blank	blank
shoelaces	shoelaces
voluntary	voluntary
executions	execut - ion - s
booty	boot - y
extinct	extinct
bang	b - ang
blade	blade
recognizable	recogniz - able
stockings	stock - ing - s
book	book
equilibrium	equilibrium
cautiously	cautious - ly
thass	thass
ironical	ironical
soul	s - oul
trains	train - s
blows	blow - s
beer	beer
enthusiasms	enthusiasm - s
loaded	loaded
squeals	squeal - s
'im	'im
waste	waste
flourish	flourish
way	way
froze	froze
swear	s - wear
sigh	sigh
slogging	s - logging
halted	halt - ed
million	million
start	start
hunched	hunched
rigidly	rigid - ly
snooping	s - noop - ing
tugging	t - ugging
fitting	fitt - ing
depicted	depict - ed
equipment	equipment
clawing	claw - ing
cutting	cutt - ing
certainty	certainty
mantelpiece	mantelpiece
reproach	reproach
command	command
improvement	improv - e - ment
loopholes	loophole - s
sixty-three	sixty-thre - e
abstruse	abstruse
seat	s - eat
grandfather	grand - father
persecution	persecut - ion
faster	fast - er
came	c - ame
battered	battered
excitedly	excit - ed - ly
violets	violets
climbed	c - limb - ed
customers	customer - s
survivors	surviv - or - s
publicly	public - ly
version	version
camera	camera
poet	poet
symbol	symbol
totally	total - ly
survived	surviv - ed
construction	construction
sentences	sentence - s
times	time - s
proximity	proximity
eagerness	eager - ness
preaches	preaches
vegetables	vegetable - s
prediction	predict - ion
commune	commun - e
thickly-populated	thickly-populated
participle	participle
grudge	grudge
sizeable	sizeable
distinction	distinct - ion
extraction	extract - ion
burner	burn - er
martin	martin
rivalry	rivalry
gaps	gaps
slavery	s - lavery
registers	register - s
shrewish	shrewish
forehead	forehead
exhibit	exhibit
flowers	flower - s
pure	pure
remonstrances	remonstrances
strolling	stroll - ing
booming	boom - ing
regained	re - gain - ed
unrepented	un - re - pent - ed
ghostly	ghost - ly
behalf	be - half
burial	buri - al
preceded	preced - ed
grain	grain
bones	b - one - s
vertebrae	vertebrae
stroke	stroke
rainwatery	rainwater - y
baal	b - aal
fornication	fornication
childish	child - ish
horse	horse
loveful	love - ful
officiousness	officiousness
half-certainty	half- - certainty
turning-point	turning-point
make	make
rebellions	rebellion - s
various	vari - ous
protest	pro - test
label	label
you	you
divide	divid - e
formidable	formidable
reappearing	re - appear - ing
bargaining	bargaining
keyhole	keyhole
sadly	sad - ly
father	father
guess	guess
engineers	engine - er - s
described	describ - ed
dishes	dishe - s
edified	edified
matched	matche - d
dentures	dentures
faintly	faint - ly
industry	in - dustry
thanks	thank - s
hedonistic	hedonistic
o'brien	o'brien
soundlessly	soundless - ly
achieve	achiev - e
pillar	pillar
too-popular	too-popular
ambiguities	ambiguities
bestrode	bestrode
seventeenth	seventeen - th
universe	univers - e
streams	stream - s
wild	wild
invasion	invasion
sheep-like	sheep-like
shortest	s - hortest
starving	starv - ing
1984	1984
beggars	beggar - s
begun	begun
lawyers	lawyers
versions	version - s
bailey	bailey
jointed	joint - ed
ability	ability
skull-like	skull-like
creating	creat - ing
ful	ful
logic	logic
mistake	mistake
rectangular	rectangular
days	day - s
routine	routine
stall	s - t - all
alliance	alliance
central	central
bill	b - ill
accord	accord
corrupt	corrupt
cobblestone	cobblestone
nations	nation - s
sheep	s - heep
stupendous	stupendous
furrows	f - urrow - s
potatoes	potato - e - s
irreconcilable	ir - reconcil - able
bitter	bitter
freckles	freckle - s
childbearing	childbear - ing
flooded	flood - ed
camaraderie	camaraderie
commoner	common - er
physique	physique
mates	mat - e - s
vanished	vanish - ed
flicks	flicks
church	church
brightened	b - right - en - ed
references	reference - s
weapons	weapon - s
mare-like	mare-like
plays	play - s
surface	surface
oblong	ob - long
everflowing	everflowing
self	self
necessities	necessit - ies
vividly	vivid - ly
intact	in - t - act
rewrite	re - write
astronomical	astronom - ical
pillow	pillow
superlatively	superlatively
anyway	anyway
firm	firm
1900	1900
awakening	awaken - ing
folded-up	folded-up
grades	grades
retch	retch
details	detail - s
worst	wors - t
than	than
arising	a - rising
bomb	bomb
line	line
devise	devise
atoms	a - tom - s
minipax	minipax
motioned	motion - ed
nowadays	nowadays
agreed	agree - d
persuade	persuad - e
charm	c - h - arm
pubs	pub - s
degradation	degrad - ation
proletariat	proletariat
denied	deni - ed
discredited	dis - credit - ed
intelligible	intelligible
ox	ox
gleam	gleam
hanged	hang - ed
adherence	a - dherence
deprived	depriv - ed
exerts	exert - s
ice	ice
extinction	extinct - ion
jeering	jeer - ing
instinctively	instinct - ive - ly
faked	fak - ed
prisoners	prison - er - s
automatically	automatic - al - ly
table-tennis	table-tennis
boomed	boom - ed
pretended	pretend - ed
doubted	doubt - ed
powers	power - s
self-propelled	self-propelled
thought-criminal	thought-criminal
destroying	destroy - ing
jet	jet
convinced	convinc - ed
lips	lip - s
hob	h - ob
mellowed	m - ellowed
recently	re - cent - ly
tinkling	tinkling
trueful	true - ful
usually	usual - ly
desert	desert
flunkies	flunkie - s
minerals	minerals
sensations	sensation - s
visualizing	visualiz - ing
schools	school - s
300	300
excellent	excellent
spying	spying
waddling	waddl - ing
without	without
ranks	rank - s
galloped	galloped
nor	nor
wilder	wilder
unbellyfeel	un - bellyfeel
obligation	obligat - ion
bribery	bribery
grave	grave
perceived	perceiv - ed
filled	fill - ed
frigid	f - rigid
declaration	declar - ation
windy	wind - y
!	!
coal	coal
clue	c - lue
married	m - arried
sniffed	sniff - ed
helicopters	helicopter - s
socialism	social - ism
jefferson	jefferson
can't	can't
handsome	handsome
bucket	bucket
concrete	concrete
contact	contact
dislocations	dislocat - ion - s
suggestion	suggest - ion
pendulum	pendulum
transit	transit
four-horse	four-horse
battleship	battle - s - hip
reversal	reversal
spreading	spread - ing
loved	love - d
twenty-seven	twenty-seven
screwdriver	s - crewdriver
85	85
comradeship	comrade - s - hip
satisfy	satisfy
supply	supply
dropping	dropp - ing
self-righteousness	self-righteousness
grouping	group - ing
acuteness	acute - ness
beforehand	beforehand
beatings	b - eating - s
favourite	favourit - e
palace	palace
everlasting	everlast - ing
fleeing	fleeing
food	food
kicks	kick - s
acquiring	acquir - ing
quarto-sized	quarto-sized
directing	direct - ing
reassured	reassur - ed
loudness	loudness
slum	slum
actually	actual - ly
surveillance	surveillance
faking	f - aking
third	third
discontented	dis - content - ed
disobey	dis - obey
technology	technolog - y
intent	intent
preserve	p - re - serve
concealed	conceal - ed
status	statu - s
army	arm - y
boring	boring
learn	learn
secret	secret
sudden	sudden
'isself	'isself
surplus	s - urplus
fair-haired	fair-hair - ed
fell	f - ell
yelling	yell - ing
casting	cast - ing
trade-union	trade-union
troubled	troubl - ed
illegitimately	illegitimately
1970	1970
nonexistence	nonexistence
syntax	syntax
flitting	flitting
official	official
successive	success - ive
sulphuric	sulphuric
'eals	'eal - s
pale-coloured	pale-coloured
equipped	equipped
affix	affix
significance	significance
native	native
mug	mug
thereafter	thereafter
baths	bath - s
pocket	pocket
possibly	possibly
two	two
abyss	aby - s - s
characteristic	characteristic
incriminate	in - criminat - e
read	read
played	play - ed
fitfully	fitful - ly
pleasure	pleasure
proceeding	proceed - ing
sleepy	sleep - y
logistics	logistics
humiliated	humiliat - ed
minority	minor - ity
snapping	snapp - ing
all-round	all-round
twos	two - s
endless	endless
shrink	shrink
walking	walk - ing
upheavals	upheavals
drawing	draw - ing
removed	re - moved
russia	russia
indistinctly	in - distinct - ly
expended	expend - ed
requires	requir - e - s
bargainings	bargaining - s
concepts	concept - s
groin	groin
definitely	definite - ly
stuck	s - tuck
liquid	liquid
twitch	twitch
selfabasement	self - abasement
known	know - n
venereal	venereal
ally	all - y
sharp-pointed	s - harp-pointed
blind	blind
chiefs	chief - s
blond	blond
essentially	essential - ly
explore	explore
breathe	breath - e
train	t - rain
burst	burst
arst	arst
wine	wine
addressed	address - ed
concerned	concern - ed
roamed	roamed
narrowed	narrow - ed
delicate	delicate
records	record - s
monotonous	monotonous
shudder	shudder
december	december
involuntary	in - voluntary
plead	p - lead
sacrificed	sacrific - ed
slit	s - lit
gratitude	gratitud - e
unprocurable	un - procur - able
arrowslits	arrowslits
whitequilted	whitequilted
snakes	snakes
spanking	s - pan - king
brown-coloured	brown-colour - ed
restricted	re - strict - ed
debased	debas - ed
airfields	airfield - s
fluted	fluted
especial	especial
breasts	breast - s
tiredness	tiredness
sides	side - s
'as	'a - s
bugs	bug - s
drums	drum - s
fastener	fast - en - er
gleamed	gleam - ed
gin	gin
helplessness	helpless - ness
pursued	pursu - ed
blocking	b - lock - ing
lap	lap
meditated	meditat - ed
objects	object - s
astonishment	astonish - ment
brazzaville	brazzaville
precautions	p - re - caution - s
navigate	navigate
pannikins	pannikin - s
study	study
preterite	preterite
regular	regular
avert	avert
instead	in - stead
'eart	'ear - t
fourth	four - th
necessitated	necessitat - ed
unscrew	un - screw
mobile	mobile
low-ceilinged	low-ceilinged
glanced	glanc - ed
rule	rul - e
face	face
missing	mis - sing
shops	s - hop - s
was	was
dice-box	dice-box
perfected	perfect - ed
awakened	awaken - ed
rabbit	rabbit
robin	robin
fixture	fixtur - e
gracelessness	grace - less - ness
is	is
repudiate	repudiate
intrigued	intrigue - d
summer	summer
attracting	attract - ing
frail	f - rail
remnants	remnant - s
saplings	saplings
moustaches	moustache - s
secretary	secret - ary
tracing	t - r - acing
canvas	canvas
normal	normal
greedy	greedy
curious	curiou - s
crushing	c - rush - ing
belch	belch
subsidiary	s - ubsidiary
rendered	render - ed
disgraced	disgraced
curving	curv - ing
distaste	dis - taste
if	if
munition	m - unit - ion
belongings	belong - ing - s
foul	f - oul
hang	hang
standard	standard
faroe	faroe
closer	clos - er
floodlit	floodlit
mails	mail - s
softly	soft - ly
unbearable	un - bearable
windows	window - s
singing	sing - ing
frightened	frighten - ed
specifically	s - pecific - ally
smoke	smok - e
comparison	comparison
absolutely	absolute - ly
600	600
impossibility	im - possibilit - y
learning	learn - ing
clarified	c - larified
ball	b - all
keyholes	keyhole - s
outlines	outline - s
plans	plan - s
shiny	shin - y
amateurishly	amateur - ish - ly
spirally	spiral - ly
contorted	contort - ed
dullbrown	dullbrown
quietly	quiet - ly
subtilized	subtiliz - ed
disappointment	disappoint - ment
sentence	sentence
superior	s - uperior
born	born
dust	dust
arrayed	arrayed
dictating	dictat - ing
applied	applied
effect	effect
adapted	adapted
aeroplane	aeroplane
justify	justify
aggressions	aggression - s
tentatively	tentative - ly
protuberant	protuberant
temporarily	temporarily
acrorss	acrorss
brought	brought
doves	dove - s
evils	evil - s
odds	odd - s
breed	breed
almost	al - most
sealed	sealed
subject	subject
word	word
sat	s - at
appearing	appear - ing
stomach	stomach
decision	decis - ion
deathly	death - ly
notice	notice
disguise	dis - guis - e
uttered	utter - ed
somehow	somehow
easier	easi - er
cup	c - up
throughout	t - hroughout
virtue	virtue
nakedness	naked - ness
wrench	wrench
hockey-sticks	hockey-sticks
fingernails	fingernail - s
crowding	crowd - ing
dozens	dozen - s
working-out	working-out
exposed	expos - ed
sank	s - ank
calculating	calculat - ing
form	form
find	find
support	support
hum	hum
jabbed	jabb - ed
cinders	c - in - der - s
mere	mere
parasites	parasites
lifes	life - s
fantasy	fantasy
half-remembered	half- - remember - ed
bloody	blood - y
stuff	stuff
ounces	ounces
refuse	refus - e
fruit	fruit
these	these
shelf	shelf
unity	unit - y
rhymes	rhyme - s
science	science
garbled	garbled
rising	rising
avaricious	avaricious
thump	thump
whatever	whatever
improvised	improvis - ed
unclean	un - c - lean
saved	sav - ed
compartments	compartments
iron-shod	iron-shod
buzz	buzz
misquotations	misquotation - s
spells	s - p - ell - s
irrevocable	irrevocable
supposed	suppos - ed
incurred	incurr - ed
jerk	jerk
biological	biological
horrors	horror - s
killing	kill - ing
proceeded	proceed - ed
rabbit-bitten	rabbit-bitten
wreckage	wreckage
yard	yard
authorized	author - ized
canteen	canteen
destroy	destroy
competing	compet - ing
prizefighter	prizefighter
residue	residue
unalterable	un - alterable
to-and-fro	to-and-fro
away	a - way
nostalgic	nostalgic
bigoted	bigot - ed
probable	p - robable
flash	flash
fours	four - s
destroys	destroy - s
consecutive	c - onsecutiv - e
judging	judg - ing
mechanics	mechanic - s
transferred	transferr - ed
washed	wash - ed
civilization	civilization
incautiously	in - cautious - ly
pepper	pepper
socialist	socialist
character	character
polishing	polish - ing
diamond-shaped	diamond-shaped
cut	cut
impressive	impress - ive
link	link
tasks	task - s
unwearying	un - wear - y - ing
concerns	concern - s
whether	whether
brisk	b - risk
fired	fir - ed
'alf	'alf
satisfying	satisfy - ing
internal	internal
attaching	attach - ing
rackety	racket - y
gelatinous	gelatinous
theme-song	theme-song
paying	p - aying
wished	wish - ed
concretely	concrete - ly
suffered	s - uffer - ed
jollying	jollying
effectively	effect - ive - ly
eternity	eternity
daughters	daughter - s
reek	reek
working-hours	working-hour - s
irresolutely	irresolutely
loaf	loaf
fidget	fidget
passed	pass - ed
events	event - s
flashing	flash - ing
philosophy	philosoph - y
morals	moral - s
guide	guide
protruded	protrud - ed
crowded	crowd - ed
haunt	haunt
drag	drag
appeal	appeal
lunacy	lunacy
minor	minor
graduating	graduat - ing
conviction	convict - ion
transcription	t - ranscription
worrying	worry - ing
writhed	writh - ed
owners	own - er - s
sacking	sack - ing
estimated	estimate - d
portraits	portrait - s
irrepressible	irrepressible
novel	novel
all-out	all-out
reverie	reverie
justice	justice
nazis	nazi - s
beggar	beggar
overcame	overcame
deciding	decid - ing
technique	technique
tiger	tiger
mrs	mrs
break	break
tension	tens - ion
clamped	c - lamp - ed
memorizing	memoriz - ing
circumstances	circumstance - s
consorting	con - sort - ing
chapter	chapter
monstrous	monstrou - s
permanently	permanent - ly
conveyed	convey - ed
retention	re - tention
satisfactorily	satisfactorily
forge	forge
glaring	glaring
anger	ang - er
comradely	comrade - ly
massacres	massacres
eased	ease - d
laboratories	laboratorie - s
backstreet	back - street
maidens	maiden - s
healing	heal - ing
regarded	regard - ed
rhythmic	rhythmic
,	,
gory	go - r - y
robes	rob - e - s
roman	ro - man
brassy	brass - y
tang	t - ang
tumbling	tumbl - ing
breakfast	breakfast
ultimate	ultimate
swum	swum
lay	lay
velvet	velvet
watching	watch - ing
spoons	spoon - s
winters	winter - s
comforting	comfort - ing
map	map
ill-lit	ill-lit
outwards	outward - s
exchanged	exchange - d
owned	own - ed
pronounced	pronounce - d
sneaked	sneak - ed
boiled-cabbage	boiled-cabbage
orgasm	orgasm
pack	pack
rods	rod - s
explanation	explanation
eurasia	eurasia
arrested	arrest - ed
assisted	assisted
refers	re - fer - s
sucked	sucked
didactically	didactically
blasphemy	blasphemy
wriggled	wriggl - ed
surname	surnam - e
reproduce	re - produc - e
wouldn't	w - ouldn't
me	me
thank	thank
miss	miss
pint	p - int
foolproof	foolproof
revived	reviv - ed
convince	convinc - e
grim	grim
realizing	realiz - ing
resting	rest - ing
shambled	s - hambled
deny	deny
vertically	vertically
wilsher	w - ilsher
complete	complete
staircase	staircase
neighbourhood	neighbour - hood
pinch	pinch
front	front
cheering	cheer - ing
green	green
hardening	hard - en - ing
sixth	sixth
unmistakable	unmistakabl - e
witty	witty
essay	essay
gazed	gaze - d
glazed	glazed
affairs	affair - s
europe	europ - e
hearts	heart - s
purged	purge - d
resemblance	re - semblance
short	short
alighted	a - light - ed
uneven	un - even
no	no
quiet	quiet
great	great
zealot	zealot
self-hypnosis	self- - hypnosis
sending	s - ending
dislike	dis - like
prompted	prompt - ed
untruth	un - truth
i._e.	i._e.
six	six
campaigns	campaign - s
doubleplusgood	doubleplus - good
bleating	bleat - ing
pouches	pouch - e - s
established	establish - ed
generation	generation
etiolated	etiolat - ed
cage	c - age
leaping	leap - ing
mankind	mankind
consumption	con - sumption
individuals	individual - s
stiffening	stiffen - ing
accused	accus - ed
although	al - though
bit	bit
grandchildren	grand - children
impossibly	im - possibly
bursting	burst - ing
moods	mood - s
?	?
enlarge	en - large
eccentricity	eccentricity
envelope	envelop - e
experience	experience
katharine	katharine
sunlight	s - un - light
paddington	paddington
brain	b - rain
wealth	wealth
recaptured	re - captur - ed
african	african
equivocal	equivoc - al
unconsciously	un - consciou - s - ly
cultural	cultur - al
exceedingly	exceedingly
bus-stop	bus-stop
denial	deni - al
curable	curab - le
changing	c - hang - ing
tracking	track - ing
wanting	want - ing
atmosphere	a - tmosphere
enjoying	enjoy - ing
complexity	complex - ity
seduced	seduc - ed
sheaves	s - heav - e - s
quickly	quick - ly
advocating	advocat - ing
cry	cry
moisture	moisture
vehicle	vehicle
retreated	re - treat - ed
bliss	bliss
laid	laid
any	an - y
enrolled	en - roll - ed
either	either
fuzzy	fuzz - y
cadging	cadg - ing
range	rang - e
settled	settle - d
climbing	c - limb - ing
documentary	document - ary
fabrication	fabric - ation
deaths	death - s
typical	typical
midday	midday
cartoons	cartoons
in-laws	in-laws
neck	neck
sliding	slid - ing
creaking	creak - ing
prize-fighter	prize-fighter
assent	a - s - sent
clipped	c - lipped
nails	nails
tubes	tube - s
blazing	blaz - ing
cumbersome	cumbersome
spanner	spanner
closesmelling	closesmelling
triangular	triangular
imagined	imagin - ed
knocked	knock - ed
shaken	s - hake - n
dreamed	dream - ed
exactly	exact - ly
selfdenial	selfdenial
reserve	re - serve
sites	sites
detected	detect - ed
well-appointed	well-appointed
west	w - est
beget	be - get
author	author
currents	current - s
feeble	feeble
pulp	pulp
despair	despair
rationalism	rational - ism
turns	turn - s
uproar	up - roar
guns	gun - s
half-page	half-page
readjustment	re - adjust - ment
drug-taking	drug-tak - ing
bothering	bother - ing
overcoat	overcoat
vitality	vital - ity
leaflets	leaflets
rent	rent
syringe	s - yringe
whisper	whisper
birds	bird - s
dimmed	dimm - ed
perfection	perfect - ion
institute	institute
compiling	compil - ing
proletarian	proletarian
refs	ref - s
meritorious	meritorious
tuft	tuft
crush	c - rush
vaguely	vague - ly
themselves	themselves
bright	b - right
plusgood	plusgood
windowless	window - less
subtlest	subtl - est
double	doubl - e
life-and-death	life-and-death
rational	rational
disposed	dispos - ed
chuckling	chuckl - ing
learnt	learn - t
simplest	simpl - est
stupefied	stupefi - ed
earlier	earli - er
per	per
toy	toy
doctrine	doctrine
almost-deserted	almost-deserted
eleven	el - even
imagining	imagin - ing
pad	pad
stowed	stowed
remoter	remote - r
structure	structur - e
uselessness	useless - ness
tentative	tentative
abstainer	abstainer
grabbed	grabb - ed
pocketed	pocket - ed
someone	someone
plexus	plexu - s
20	20
flurry	f - lurry
shot	s - hot
undermost	undermost
candle-lit	candle-lit
ink-pencil	ink-pencil
swimming	swimming
sturdy	s - t - urdy
frequent	frequent
erroneous	erroneous
vague	vague
pre-industrial	p - re- - industrial
reporting	report - ing
sharpness	sharp - ness
conquerable	conquer - able
instituted	institute - d
looped	looped
selfishness	selfish - ness
japanese	japane - s - e
please	please
massed	mass - ed
nip	nip
obedience	obedience
martyrdoms	martyrdom - s
linking-together	linking-together
manufacture	manufacture
locket	locket
electrically	electric - ally
swung	s - w - ung
dual	dual
condemned	condemn - ed
hypnosis	hypnosis
instance	instance
released	releas - ed
horizontally	horizontal - ly
evil-tasting	evil-tasting
committing	committ - ing
illiterate	illiterat - e
salt	salt
altercation	altercation
smashed	smash - ed
societies	societ - ies
cold	cold
half-hearted	half-hearted
magnifying	magnify - ing
protected	protect - ed
flagged	flagg - ed
nought	n - ought
sleeping	sleep - ing
middle-aged	middle-aged
interstellar	interstellar
stands	stand - s
hearing	hear - ing
concept	concept
propaganda	propaganda
excluding	exclud - ing
glancing	glanc - ing
good	good
get	get
julius	julius
keenness	keenness
barbarities	b - arbarities
negative	negativ - e
inspiration	inspir - ation
noticed	notice - d
larynx	larynx
rehashing	rehash - ing
gallery	gallery
rowdy	rowdy
generated	generate - d
shook	shook
3rd	3rd
suicide	s - uicid - e
drew	drew
tepid	tepid
twice	t - w - ice
basis	b - asis
enunciating	enunciating
urbane	urbane
victory	victor - y
chance	chanc - e
door-knob	d - oor-knob
each	each
flame	flame
printing	print - ing
chalked	chalk - ed
helpless	helpless
knotted	knot - t - ed
explain	explain
extreme	extreme
underfoot	underfoot
flit	f - lit
lonely	lonely
uncommanded	un - command - ed
parasitical	parasitical
buying	buying
dissipated	dissipat - ed
shoved	shov - ed
emotional	emotion - al
100	100
encouragement	encourag - e - ment
good-thinking	good-think - ing
plottings	plotting - s
uninterested	un - interest - ed
ankle	ankle
incongruous	incongruous
pride	pride
optimism	optimism
planned	plann - ed
plug	plug
lights	light - s
origins	origin - s
alluring	alluring
sound-tracks	s - ound-track - s
meeting	meet - ing
watch	watch
opportunity	opportunity
agricultural	agricultural
sledge-hammer	s - ledge-hammer
brush-down	brush-down
thousand	thousand
flinched	flinch - ed
wooden-faced	wooden-fac - ed
largest	large - s - t
flowed	flow - ed
nausea	nausea
mansions	mans - ion - s
come	c - ome
'	'
thrashing	thrash - ing
above	above
weeks	week - s
tragedy	t - rag - ed - y
utopianism	utopianism
enjoyment	enjoy - ment
title	title
rape	rap - e
ulcer	ulcer
tastes	taste - s
leaf	leaf
invent	invent
politically	political - ly
controls	control - s
refrain	refrain
realization	realiz - ation
mercy	mercy
tyrannies	tyrannie - s
champagne	champagne
back	back
oddly	odd - ly
registered	register - ed
prove	prov - e
hurt	hurt
chess	c - he - s - s
gravity	grav - ity
inheritors	inherit - or - s
kneeling	kneeling
lugged	lugged
north	n - orth
attention	a - t - tention
instant	instant
announced	announce - d
reports	report - s
smear	s - m - ear
target	target
thrush	t - h - rush
turnip	turnip
cups	cup - s
indefinable	in - defin - able
persisted	persist - ed
musical-box	musical-box
card	car - d
subtly	subtl - y
neighbour	neighbour
nipped	nipp - ed
notice-board	notice-board
pretending	pretend - ing
prizes	p - r - ize - s
1965	1965
exceptions	exception - s
risks	risk - s
sickening	sicken - ing
junk-shop	junk-shop
neighbours	neighbour - s
supplementary	supplement - ary
cities	c - ities
treatment	treat - ment
thrill	t - hrill
high-ceilinged	h - igh-ceilinged
wander	wander
chiefly	chief - ly
madness	m - adness
exploits	exploit - s
rinsed	rinse - d
inert	inert
layers	lay - er - s
geared	gear - ed
inflict	inflict
operation	operat - ion
whips	whips
appointed	appointed
land	land
keyword	keyword
makes	make - s
white-aproned	white-aproned
consumable	consum - able
fix	fix
bureaucrats	b - ureaucrat - s
barked	bark - ed
entire	entire
extraordinary	extraordinar - y
breeding	breed - ing
barbarous	barbarou - s
patterns	pattern - s
source	source
startling	startl - ing
bunks	b - unk - s
worship	wors - hip
personality	person - al - ity
synthesize	synthesize
corners	corner - s
goodest	good - est
hopeless	hopeless
nearest	near - est
everlastingly	everlast - ing - ly
unavoidable	un - avoid - able
mute	mute
religious	religious
resist	resist
stone	s - t - one
substitute	substitut - e
demolished	demolish - ed
burly	b - urly
bars	bar - s
kent	kent
intellectually	intellectual - ly
upright	up - right
volunteers	volunteer - s
imaginary	imagin - ary
hikes	hike - s
message	message
slithering	slither - ing
immediately	immediate - ly
since	s - ince
grew	grew
instruments	instrument - s
bosom	bosom
re-adjusted	re- - adjust - ed
mechanical	mechanic - al
nose	no - s - e
except	except
seems	seems
sticking	s - ticking
clever	c - lever
cringe	c - ring - e
concentrate	concentrat - e
fed	f - ed
slapped	s - l - app - ed
b.b.	b.b.
demanding	demand - ing
hurried	hurried
histories	histor - ies
strangers	s - t - rang - er - s
whispers	whisper - s
satisfactory	satisfactory
presupposed	p - re - suppos - ed
reflexes	reflexe - s
entries	entrie - s
thereby	t - hereby
undeclared	un - declared
brute	brut - e
squeezing	squeez - ing
veins	veins
bulletin	bulletin
merely	mere - ly
demographic	demographic
calling	call - ing
inflected	inflect - ed
tunefully	tuneful - ly
cracked	crack - ed
occurs	occur - s
spoiled	s - p - oil - ed
momentous	moment - ous
strike	strik - e
defined	defin - ed
already	already
sandy	sandy
cheekbone	cheekbone
harder	hard - er
salary	salary
bondage	bondage
smartly	smart - ly
leaders	leader - s
saw	s - aw
guessed	guess - ed
bottling	bottl - ing
shallowness	shallow - ness
sore	s - ore
comforts	comfort - s
oxes	oxes
uncalled	un - call - ed
needle	needle
grassy	gras - s - y
hide	hi - d - e
less	less
f	f
sugar	sugar
violations	violations
capitalism	capital - ism
deep-bosomed	deep-bosomed
metallic	metallic
breath	breath
generally	general - ly
tamper	tamper
doubly	doubl - y
obtain	ob - tain
belong	belong
servile	servile
sounds	sound - s
itself	itself
tickled	tickle - d
fingers	finger - s
pantry	pantry
went	w - ent
worshipped	worshipped
tufts	tuft - s
creased	creas - ed
charge	charge
claimed	claim - ed
attached	attach - ed
sinecures	sinecure - s
farthings	farthing - s
knelt	knelt
stretch	stretch
switch	switch
rutherford	rutherford
scarlet	s - carlet
humorous	humorous
foot	foo - t
spread	spread
:	:
accordingly	accord - ing - ly
packets	packet - s
thoroughfare	t - horoughfare
waging	waging
alignment	alignment
referring	referr - ing
aimed	aim - ed
trucks	truck - s
how	how
limply	limp - ly
horse-ploughs	horse-ploughs
pact	p - act
leadership	leader - s - hip
lice	lice
unwise	un - wise
biologist	biologist
inconvenient	in - convenient
peculiarities	peculiar - ities
pale-grey	pale-grey
transformed	transform - ed
columns	column - s
hush	hush
being	being
spared	spare - d
thoughts	thought - s
interesting	interest - ing
pedant	pedant
cheese	chees - e
lifeless	lifeles - s
filthy-tasting	filthy-tasting
lifetime	lifetime
lusty	lust - y
martin's-in-the-fields	martin's-in-the-fields
specialist	specialist
stay	stay
nerved	nerve - d
palpable	palpabl - e
palm	palm
finally	final - ly
preparation	preparation
ticking	ticking
mending	m - ending
swam	s - w - am
julia	julia
dimly	dim - ly
ripe	ripe
fairly	fair - ly
few	few
stationary	station - ary
open	open
trees	tre - e - s
tennis	tenni - s
dabs	dabs
distance	distance
received	receiv - ed
[	[
escaped	escap - ed
half-litres	half-litre - s
bar	bar
longed	long - ed
obsolete	obsolete
termination	t - ermination
enchanter	en - chant - er
horribly	horribl - y
privation	privation
awye	aw - y - e
ambitious	ambitious
erasure	erasure
newly-created	newly-creat - ed
bleeding	bleeding
occupying	occupy - ing
approaching	approach - ing
disappointed	disappoint - ed
bunting	b - un - ting
balance	balanc - e
flakes	flake - s
inconsequently	in - consequently
unreasonable	un - reason - able
'is	'is
minilovely	mini - lovely
expressionless	express - ion - less
categorical	categoric - al
station	station
slips	s - lip - s
gun	gun
dark-haired	dark-haired
1930	1930
catalogue	catalogue
technical	technical
malabar	malabar
mischievous	mischievou - s
injustice	in - justice
roofs	roof - s
drove	drove
misdemeanour	mis - demeanour
quarry	quarry
salutation	salutation
comb	comb
led	l - ed
smuggle	smuggle
rise	rise
struck	s - truck
centuries	centur - ies
sect	sect
following	follow - ing
stratosphere	stratosphere
lacks	lack - s
swelled	s - well - ed
unpersons	un - person - s
claptrap	c - laptrap
sweetness	sweet - ness
shuffled	shuffl - ed
grimmer	grimmer
wash-basin	wash-basin
truthful	truthful
sound	sound
ecstasy	ecstasy
realizable	realiz - able
fender	f - end - er
dwellings	dwelling - s
c	c
er	er
ruminant	ruminant
fragment	fragment
trickled	trickl - ed
accomplishes	accomplish - e - s
consequences	consequence - s
gent	gent
gramophone	gramophon - e
eliminating	eliminat - ing
prodigious	prodigiou - s
gardening	garden - ing
earthquakes	earthquakes
captain	captain
impulses	impulse - s
actions	action - s
oligarchical	oligarch - ical
polits	polits
fill	fill
sub-human	sub-human
adulation	adulation
editions	edition - s
succeeded	succeed - ed
internationalism	international - ism
illusion	illusion
rights	right - s
fencing	fencing
addition	addition
kong	kong
lock-up	lock-up
blocks	b - lock - s
institution	institution
entangling	entangl - ing
impudence	impudence
downwards	downwards
governs	govern - s
contralto	contralto
extra	extra
stallkeeper	stallkeeper
communications	communicat - ion - s
directly	direct - ly
south	s - outh
sunk	s - unk
splitting	s - p - litting
thin	t - hin
using	using
shreds	shr - ed - s
disconcerting	disconcert - ing
this	t - his
destroyed	destroy - ed
camp	camp
according	accord - ing
tremendous	tremendous
fatuous	fatuou - s
greatly	great - ly
passing	pass - ing
wrinkles	w - rinkle - s
poles	pole - s
patted	patt - ed
curiously	curiou - s - ly
exclaimed	exclaimed
scrutiny	s - crutiny
do	do
identification	identifi - cation
shapely	shape - ly
gravitates	gravitat - e - s
rubbish-heap	rubbish-heap
draught	draught
quacked	quack - ed
irises	irise - s
achieved	achiev - ed
dye	d - ye
generalities	general - ities
boarded	board - ed
contemplate	contemplat - e
unless	un - less
destructive	destructive
himself	himself
discontent	dis - content
noun	noun
consideration	consider - ation
disturbed	disturbed
inkpot	inkpot
solemnity	solemn - ity
forcing	forc - ing
transformation	transform - ation
clenching	clenching
express	express
uninhabited	un - inhabited
disarming	disarming
queen	queen
creak	creak
during	during
military	military
frog-like	frog-like
confess	confess
missed	miss - ed
stimulant	stimulant
engineer	engine - er
tanks	tank - s
used	used
comparatively	comparative - ly
illegal	illegal
kilo	kilo
doubling	doubl - ing
hypnotic	hypnotic
dreadful	dread - ful
conclusion	conclusion
newspeak	newspeak
higher	high - er
treat	treat
rumoured	rumour - ed
comrade	comrade
take	take
nosers-out	n - osers-out
amusement	amuse - ment
advisable	advisable
commas	comma - s
variant	variant
practicable	practic - able
intelligence	intelligence
inaudibly	inaudibly
chimney-pots	chimney-pot - s
whitish	whitish
stink	s - t - ink
disposes	dispos - e - s
tighter	tight - er
disabled	dis - able - d
discovered	dis - cover - ed
ingenious	ingenious
statutory	statutory
connexion	connexion
cultivation	cultivat - ion
whenever	whenever
declaring	declar - ing
courage	courage
glitter	glitter
sorts	sort - s
been	b - een
flames	flame - s
paperweight	paper - weight
prevaricate	prevaricate
feared	fear - ed
protective	protect - ive
rumpelstiltskin	rumpelstiltskin
draughty	draught - y
slogan	slogan
plastered	plaster - ed
remains	remain - s
stealed	steal - ed
worn-out	worn-out
disproportionately	disproportionately
grizzled	grizzled
wail	wail
too	too
pancras	pancras
passage-way	passage-way
momentarily	momentarily
sooner	soon - er
slow-moving	slow-moving
acted	act - ed
aeroplanes	aeroplane - s
kilometre	kilometre
pick	pick
secretly	secret - ly
passage	passage
resentment	re - sentment
wind	wind
devour	devour
protection	protect - ion
stones	s - t - one - s
traced	trace - d
waxwork	waxwork
waste-pipe	waste-pip - e
compromising	compromis - ing
beads	beads
foreknowledge	fore - knowledge
resistance	resist - ance
ever	ever
them	them
yp	yp
ought	ought
shoot	shoot
stepping	stepp - ing
darkening	darken - ing
gestapo	gestapo
may	may
stanza	s - tanza
on	on
magnified	magnifi - ed
exactitude	exactitude
france	france
compilation	compil - ation
permission	permission
raping	raping
imagine	imagin - e
chinless	chinle - s - s
coast	c - oast
easy	easy
organizer	organiz - er
sort	sort
noise-filled	noise-fill - ed
two-storey	t - w - o-storey
snap	snap
deaf	deaf
oval	oval
glances	glanc - e - s
ridiculed	ridicul - ed
brightly-lit	brightly-lit
exist	exist
arrogant	arrogant
visit	visit
bear	bear
agree	agree
captured	captur - ed
relapse	re - lap - s - e
lashes	lashe - s
parenthood	parent - hood
swallowing	swallow - ing
upwards	upward - s
others	other - s
servant	servant
depth	depth
tool-bag	tool-bag
speck	speck
week	week
denunciation	denunciation
achievement	achievement
playground	playground
breadcrumbs	breadcrumbs
rewriting	re - writing
arguments	argument - s
swept	swept
juggling	juggl - ing
vacant	vacant
rested	rest - ed
arrest	arrest
rice	rice
furniture	furniture
couple	coupl - e
inviolate	in - violate
men	m - en
newsflash	newsflash
guilty	guilty
refusing	refus - ing
swelling	s - well - ing
bloke	bloke
vanquished	vanquished
article	article
bellyfeel	bellyfeel
persons	person - s
besides	be - sides
convert	convert
authoritarian	authoritarian
arranging	arrang - ing
fancied	fanci - ed
thinking	think - ing
memory	memor - y
solve	solve
hope	hop - e
wisdom	wisdom
scrapped	s - c - rapped
tied	tied
credible	credible
spite	spit - e
mine	mine
contemptible	contemptible
sacrificing	sacrific - ing
grip	grip
experimental	experiment - al
shift	shift
dictates	dictat - e - s
callouses	callouses
loathing	loath - ing
hardly	hard - ly
waiting	wait - ing
actual	actual
steep	steep
formations	formation - s
crimes	crime - s
rebel	re - bel
nearness	nearness
outlived	outliv - ed
serious	serious
subjects	subject - s
muck	m - uck
exaggeration	exaggerat - ion
crouching	crouch - ing
keep	keep
tripping	t - ripping
armaments	armaments
calamity	calamity
bearable	bearable
also	also
before	be - fore
grammar	grammar
high-sounding	high-sounding
remark	remark
abolished	abolish - ed
mattress	mattress
difficulties	difficult - ies
underfed	un - d - erfed
coarse	coarse
assimilate	assimilate
disreputability	dis - reputability
gutters	gutter - s
chivalrous	chivalrous
edged	edge - d
fatigue	fatigue
pen	p - en
rebellious	rebellious
boughs	bough - s
mouthpiece	mouthpiece
cleverness	c - lever - ness
'and	'and
backbone	backbone
ceremony	ceremon - y
together	together
torture	torture
versificator	versificator
wretches	wretch - e - s
abbreviating	abbreviat - ing
habitually	habitual - ly
entered	enter - ed
instructress	instructre - s - s
mugs	mug - s
j.	j.
submitting	submit - t - ing
acute	acute
platforms	platform - s
sorrow	sorrow
affair	affair
inevitable	inevitable
1925	1925
hemmed	hemmed
murmured	murmur - ed
tenet	tenet
administrators	administrator - s
dangers	danger - s
acquired	acquir - ed
myth	myth
deliberate	deliberate
hold	hold
intervention	intervention
younger	young - er
crust	crust
spontaneously	spontaneous - ly
precisely	precis - e - ly
wear	wear
expression	express - ion
blunt-featured	blunt-featured
overnight	over - night
knights	knight - s
punishment	punish - ment
soon	soon
begged	begg - ed
result	result
unable	un - able
antegetting	ante - getting
disappearances	dis - appearance - s
forty-eight	forty-eight
jaw	jaw
episode	episode
figure	figure
found	found
agitprop	agitprop
patched	patch - ed
future	futur - e
ravish	ravish
rushing	rush - ing
sinister	s - inister
flung	f - lung
razor	r - azor
stitching	s - t - itching
stick	stick
unfortunately	un - fortunately
expected	expect - ed
resembles	re - semble - s
unreservedly	un - reserved - ly
boldness	b - oldness
branched	branch - ed
unquestionably	un - question - ably
coral	coral
co-ordinated	co-ordinat - ed
knots	knot - s
nineteen-fifties	nineteen-fifties
unknown	unknown
cockney	cockney
collaborated	collaborated
fit	f - it
misdeeds	mis - deed - s
whirling	whirl - ing
17.3.84	17.3.84
hall	h - all
rustle	rustle
mind	mind
uses	us - e - s
wiping	wiping
fitness	fitness
precedes	preced - e - s
karl	karl
jerked	jerk - ed
lunge	lung - e
crossing	cross - ing
mixed	mixed
adjectives	adjectiv - e - s
dabbling	dabbling
surroundings	surround - ing - s
twelve-hour	twelve-hour
screwing	screw - ing
unsupported	un - support - ed
jammed	jammed
perturbed	perturb - ed
vivid	vivid
intoxication	intoxicat - ion
trivialities	trivial - ities
kissing	kiss - ing
stores	stor - e - s
eager	eager
foregoing	foregoing
lingered	linger - ed
outlined	outline - d
systematized	systematiz - ed
establishment	establish - ment
stench	stench
hide-out	hide-out
splits	s - p - lit - s
thoroughly	thorough - ly
many	man - y
nickname	nickname
lethargy	letharg - y
noun-verb	noun-verb
bend	b - end
kilograms	kilograms
ah	ah
flaw	f - law
mothers	mother - s
purchased	purchased
patient	patient
thereabouts	t - hereabouts
coughed	cough - ed
convenience	convenience
menaced	menac - ed
flies	f - lie - s
attitudes	attitude - s
industrially	industrial - ly
punish	punish
tele-programmes	tele-programme - s
2	2
inertia	inertia
most	most
attendants	attendants
seldom	s - eldom
establishing	establish - ing
switchover	switchover
dummy	dummy
disintegrate	disintegrate
crushed-looking	crushed-looking
encircle	encircl - e
law	law
magic	magic
arrow	arrow
adept	adept
cobbles	cobbl - e - s
greasy	greas - y
lashed	lashe - d
prepared	prepar - ed
demonstration	demonstrat - ion
rage	rag - e
torn	t - orn
growing	grow - ing
brazil	brazil
stages	s - t - age - s
vibrate	vibrate
sickly	sickl - y
diverging	di - verging
hungrier	hungrier
interminable	inter - m - inable
stillness	still - ness
scrubby	scrubb - y
picked	pick - ed
tree	tree
frosted	frost - ed
synonyms	synonyms
mad	mad
deposited	deposit - ed
putting	putt - ing
tacitly	tacitly
flog	flog
done	d - one
1960	1960
encouragingly	encourag - ing - ly
belly	bell - y
rosewood	rosewood
foresee	foresee
stronger	strong - er
repair	re - pair
vegetation	vegetation
coughing	cough - ing
young	young
deformity	deformity
hesitantly	hesitantly
heating	heat - ing
200	200
emanation	emanation
demands	demand - s
mouse	mou - s - e
shored	s - hored
vehemently	vehemently
forgetting	forgetting
impedimenta	im - pedimenta
landed	land - ed
recorded	record - ed
frequently	frequent - ly
forbidden	forbidden
group	group
lane	lane
shaking	s - h - aking
storing	stor - ing
thirty-five	thirty-f - ive
window	window
thinness	thinnes - s
drifted	drifted
hypocrite	hypocrite
stars	star - s
duty	duty
drunk	drunk
horseflesh	horseflesh
composed	compos - ed
conspirator	conspirator
tacked	tack - ed
deviations	deviation - s
screen	screen
sharp	sharp
liberalism	liberal - ism
town	t - own
convoy	convoy
inward	inward
hypocrisy	hypocrisy
never-sleeping	never-sleep - ing
intellect	intellect
god	god
guard	guard
reaching	reach - ing
factory	factor - y
include	includ - e
horns	horn - s
promptly	prompt - ly
fiery	fiery
impair	im - pair
partially	partial - ly
self-willed	self-willed
blackbirds	blackbirds
reached	reach - ed
matter	matter
from	from
at	at
merciless	merciles - s
magnifies	magnifi - e - s
dusty	dust - y
clatter	c - latter
servicing	servic - ing
feat	f - eat
believes	believ - e - s
heroes	hero - e - s
gods	god - s
jumped	jumped
brutes	brut - e - s
track	track
gained	gain - ed
album	album
crumpled	crumpled
verbs	verb - s
tones	t - one - s
wasn't	wasn't
immorality	im - morality
permanent	permanent
explosives	explosives
a	a
unending	un - ending
process	process
cream-laid	cream-laid
driven	driv - en
lust	lust
sweaty	sweat - y
hundred	hundred
ladder	ladder
revolution	revolution
history	histor - y
pyjamas	pyjamas
supposedly	suppos - ed - ly
kipling	kipling
shapes	shape - s
musing	m - using
wheedle	wheedle
cape	cap - e
forgotten-looking	forgotten - -look - ing
glassy	glass - y
highly	high - ly
kings	king - s
preceding	preced - ing
steal	steal
perversions	pervers - ion - s
betrayals	betrayal - s
into	into
mistaking	mist - aking
prop	prop
oliver	oliver
surgeons	s - urgeons
substitution	substitut - ion
finding	find - ing
arch	arch
gentleman	gentleman
stored	stor - ed
blokes	bloke - s
perpetual	perpetual
intending	intend - ing
muzzle	muzzle
stern	stern
fluctuating	fluctuat - ing
plots	p - lot - s
unlikely	unlike - ly
world-power	world-power
ear	ear
wash	wash
oil-cake	oil-cake
squalling	squall - ing
forecast	forecast
materials	material - s
paint	paint
job	job
evenly	even - ly
firearms	firearms
towards	toward - s
lingua	lingua
tubby	tubby
chief	chief
persiflage	persiflage
scar	s - car
measurable	measur - able
spectacular	spectacular
coolies	coolie - s
admitted	admitt - ed
detail	detail
disobeyed	dis - obey - ed
enthusiastic	enthusiastic
hurting	hurt - ing
degree	degree
hunt	hunt
man	man
mediterranean	mediterranean
expropriated	expropriated
fraction	f - raction
rallied	ralli - ed
slums	slums
insecurity	in - secur - ity
intolerable	intolerable
darkness	darkness
string	s - t - ring
thick	thick
opposed	oppos - ed
gutter	gutter
plundered	plundered
automatic	automatic
parody	p - a - rod - y
satisfaction	satisfaction
sawdust	sawdust
trouble	troubl - e
going	going
playing	play - ing
98	98
efficient	efficient
alongside	alongside
brackets	b - racket - s
solemn	solemn
widespread	widespread
artificial	artificial
effort	effort
drill	drill
helping	help - ing
toys	toy - s
undone	un - d - one
athleticism	athletic - ism
wore	w - ore
which	which
meanwhile	meanwhil - e
long	long
stump	stump
quarrel	quarrel
smelling	smell - ing
confidence	confidence
vilely	vile - ly
collapsed	c - ollaps - ed
jostled	jostled
wince	w - ince
sports	sport - s
experts	expert - s
gesture	gesture
america	america
difficult	difficult
minitruthful	mini - truthful
abstract	abstract
rubbing	rubb - ing
streets	street - s
vistula	vistula
slots	s - lot - s
sweeps	s - weep - s
impact	im - p - act
degrading	degrad - ing
ghastly	ghastly
seeks	seek - s
safer	s - a - fer
commanded	command - ed
mongol	mongol
talents	talent - s
submit	submit
atomic	atomic
easily	easi - ly
muslin	muslin
mystical	mystical
hopes	hop - e - s
breakdown	breakdown
construct	construct
granted	grant - ed
severed	s - ever - ed
involved	involv - ed
pangs	pang - s
darting	dart - ing
begins	begin - s
selfdeception	self - deception
why	why
brilliantly	brilliantly
dissolved	dis - solved
incredible	in - credible
ashtaroth	ashtaroth
problem	problem
talk	talk
ripping	ripping
wickedness	wicked - ness
polished	polish - ed
chop	c - hop
long-shaped	long-shaped
summery	summer - y
hallucinations	hallucination - s
strengthened	strength - en - ed
carefully	careful - ly
laying	l - aying
duck	duck
fixedly	fix - ed - ly
flap	flap
forgiven	forgive - n
money	money
raging	raging
truisms	truism - s
underclothes	underclothes
gin-scented	gin-scented
successful	success - ful
derivation	derivation
unceasingly	un - ceas - ing - ly
2050	2050
lived	live - d
distributing	distribut - ing
equal	equal
undercharged	under - charge - d
riddle	riddl - e
rows	row - s
covering	cover - ing
demonstrations	demonstrat - ion - s
hell	hell
admits	admit - s
assumption	assumption
ingsoc	ingsoc
abolish	abolish
rats	rat - s
pornosec	pornosec
leaned	lean - ed
widower	widower
mortal	mortal
remember	remember
cubicle	cubicle
rests	rest - s
formation	formation
seek	seek
denounce	denounc - e
revolutions	revolution - s
production	product - ion
efforts	effort - s
self-contradiction	self- - contradict - ion
vagueness	vague - ness
anxious	anxious
root	root
vaporized	vaporiz - ed
looting	loot - ing
power-hungry	power-hungry
mask-like	mask-like
scalp	s - calp
aside	a - side
subterranean	s - ubterranean
whole	w - hole
protecting	protect - ing
occurring	occurr - ing
fear-ridden	fear-ridden
operate	operat - e
wantonness	w - antonne - s - s
congo	congo
likeliest	likeliest
hatred	hatred
lain	lain
learner	learn - er
ourselves	ourselves
accidentally	accident - ally
gambling	gambling
inhabitants	inhabitants
prettier	pretti - er
scale	scale
gifted	gift - ed
implicating	implicat - ing
zig-zagging	zig-zagg - ing
nippers	nipper - s
snivelling	s - nivell - ing
murderers	murder - er - s
suicides	s - uicid - e - s
split	s - p - lit
dock-worker	dock-worker
electric	electric
clearing	clear - ing
hikers	hikers
final	final
proletarians	proletarian - s
gaping	gaping
stratagem	s - tratagem
tail	tail
translucency	translucency
reasonable	reason - able
descended	descended
altering	alter - ing
films	film - s
half-heartedly	half-hearted - ly
pains	pain - s
bath	bath
deportation	deportation
ignorance	ignor - ance
answers	answer - s
snuffbox	snuffbox
statue	statu - e
quick	quick
seized	seiz - ed
stone-flagged	s - tone-flagg - ed
muttering	m - utter - ing
victor	victor
possible	possible
tillotson	tillotson
twentieth	t - wentieth
verbal	verb - al
yellowed	yellow - ed
classification	c - lassific - ation
handed	hand - ed
necessarily	necessarily
rhyme	rhyme
never-speaking	never-speaking
charred	charred
rear	r - ear
whereby	w - hereby
offenders	offend - er - s
undid	un - did
sanctuary	sanctuary
threatened	threaten - ed
barricades	barricade - s
switched	switch - ed
names	name - s
nuts	nut - s
chose	chose
dread	dread
oldspeak	oldspeak
boozer	boozer
drops	drop - s
won't	w - on't
sprung	s - p - rung
manoeuvrings	manoeuvr - ing - s
come-and-go	come-and-go
grief	grief
technician	technician
servant-like	servant - -like
elaborately	elaborate - ly
envy	envy
metaphysician	metaphysician
sixty-two	s - ixty-two
surrounding	surround - ing
southward	southward
fleeting	fleeting
midst	midst
marvellous	marvellous
graver	grav - er
increase	increase
chimneys	chimneys
forms	form - s
geographically	geographical - ly
museum	museum
forget	forge - t
window-sill	window-sill
wretched	w - retch - ed
ants	ant - s
rulers	rul - er - s
defeated	defeat - ed
spun	s - p - un
chant	chant
tradition	tradition
universal	univers - al
priest	p - riest
diminution	diminution
problems	problem - s
programme	programme
saying	s - aying
sharper	sharp - er
thinks	think - s
blackmarket	blackmarket
drinking	drink - ing
discovery	dis - cover - y
renewed	re - new - ed
fascinating	fascinat - ing
teach	teach
everybody	everybody
goods	good - s
three-year	three-year
trays	tray - s
robbed	robb - ed
figures	figure - s
habitual	habitual
even	even
bestowed	be - stowed
judges	judg - e - s
americas	america - s
reconnoitring	re - connoitring
conflict	conflict
grovelling	grovelling
fire	fir - e
searching	search - ing
human	human
threw	threw
systematically	systematic - ally
steps	s - tep - s
self-satisfied	self- - satisfi - ed
wire	wire
caution	caution
plains	plain - s
questioned	question - ed
excuse	excu - s - e
deep-laden	deep-lad - en
temples	temple - s
sheets	sheet - s
restoring	re - stor - ing
translate	translat - e
battle	battle
untranslatable	un - translat - able
contrast	contrast
exulting	exult - ing
startlingly	startl - ing - ly
poster	post - er
stupidly	stupid - ly
colourless	colour - less
ebbed	ebbed
daylight	day - light
shortly	short - ly
cover	cover
lawn	lawn
palimpsest	palimpsest
gasping	gasp - ing
overpoweringly	overpower - ing - ly
co-ordination	co-ordinat - ion
involves	involv - e - s
burned	burn - ed
deeply	deep - ly
accusing	accus - ing
irregularly	irregular - ly
waxen-faced	waxen-faced
warm	warm
five	five
expressed	express - ed
drafting	draft - ing
charity	char - ity
lottery	lottery
person	person
models	model - s
twenty-four	twenty-four
gentle	gentle
scramble	scramble
market-woman	market-woman
bony	b - on - y
february	february
float	float
correctly	correctly
teaching	teach - ing
eagerly	eager - ly
ship	s - hip
likelier	likelier
yapped	yapped
house-by-house	house-by-hou - s - e
desperate	desperat - e
submachine	sub - machine
tidal	tidal
twitched	twitch - ed
clawed	c - law - ed
always	al - way - s
w	w
leader	leader
thumping	thump - ing
persecutions	persecut - ion - s
angry	angry
pilfering	pilfering
culture	cultur - e
experiment	experiment
adequate	adequate
swarms	s - warm - s
preserved	p - reserved
clinging	cling - ing
dresses	dress - e - s
hierarchy	hierarchy
journalists	journalists
family	family
credit	credit
unsympathetic	un - sympathetic
stirring	stirr - ing
issues	issu - e - s
puddle	puddle
slanting	slant - ing
squatted	squatt - ed
touch	touch
clocks	c - lock - s
parent	parent
out	out
stream	stream
virtuosity	virtuosity
coffee	coffee
trap	t - rap
memorial	memori - al
ghost	ghost
numbers	number - s
pluscold	pluscold
ill-cut	ill-cut
rendering	render - ing
rifle	rifle
scrap	scrap
reactions	re - action - s
maintains	maintain - s
boyish	boyish
inquisitive	inquisit - ive
explosion	explosion
transparent	transparent
flushed	flushed
damp	damp
hips	hip - s
dung	d - ung
jolted	jolt - ed
fundamentally	fundamental - ly
disagreement	dis - agree - ment
live	live
questioners	question - er - s
slept	slept
sock	s - ock
diagram	diagram
prolefeed	prolefeed
kill	kill
sanctioned	sanction - ed
commonplace	commonplace
denouncing	denounc - ing
mist	mist
neurologists	neurologists
pavements	pavement - s
milky	m - ilky
disease	dis - ease
coupons	coupons
conspicuous	conspicuous
gladly	glad - ly
nature	natur - e
scraggy	s - craggy
berkhamsted	berkhamsted
parachute	parachute
rejoiced	rejoic - ed
contains	contain - s
comintern	comintern
ships	s - hip - s
etymological	etymological
crop	crop
garment	garment
reminded	re - mind - ed
mortality	mortal - ity
pushed	push - ed
silk	silk
desirable	desirable
plume	p - lum - e
arriving	arriv - ing
element	element
unfolded	un - fold - ed
black-marketeers	black-marketeer - s
overhearing	overhear - ing
fully	full - y
balminess	balmine - s - s
eurasian	eurasian
ceases	c - ease - s
capitalists	capitalist - s
forest	forest
freeze	freeze
vaporize	vaporiz - e
victim	victim
youthful	youthful
wage	w - age
pathos	pathos
rotting	rott - ing
moustache	moustache
compilers	compil - er - s
cromwell	cromwell
needles	needle - s
unimaginable	un - imagin - able
wonderful	wonder - ful
drily	dri - ly
horizontal	horizontal
bullet	bullet
sole	sole
cough	cough
swayed	s - way - ed
transmitting	transmitt - ing
ungovernable	un - govern - able
immense	immense
comfortable	comfort - able
flicker	flicker
hip	hip
publicity	public - ity
scratch	scratch
tightly-knit	tightly-knit
fuses	fus - e - s
tenets	tenet - s
victims	victim - s
course	course
quack	quack
sharing	sharing
drenched	drench - ed
gym-shoes	gym-shoes
completely	complete - ly
notices	notice - s
inherited	inherit - ed
clothing	cloth - ing
violence	violence
within	within
tampering	tamper - ing
guiltily	guilti - ly
silenced	silenc - ed
population	population
ultimately	ultimate - ly
humming	humming
entrusted	en - trust - ed
murmuring	murmur - ing
fleshy	flesh - y
sanctimonious	sanctimonious
unbelievably	un - believably
shave	s - have
watering	water - ing
slowly	s - low - ly
stead	stead
random	random
easing	easing
spoken	spoken
paralysing	paralys - ing
improved	improv - ed
succumbed	succumb - ed
spyhole	s - pyhole
filtered	filter - ed
condition	condition
extraordinarily	extraordinarily
incident	incident
infinitely	infinitely
venomously	venomou - s - ly
dazzling	dazzl - ing
fanaticism	fanatic - ism
kitchen	kitchen
inserted	inserted
seizing	seiz - ing
scores	scores
inventive	invent - ive
sloppiness	s - loppiness
vehicles	vehicle - s
ached	ach - ed
display	display
exceptional	exception - al
death	death
microphone	microphone
ends	end - s
photograph	photograph
transferring	transferr - ing
mostly	most - ly
conspire	conspire
uncovering	un - cover - ing
wandered	wander - ed
note	note
weaving	weav - ing
countersign	countersign
world-conquest	world-conquest
beams	beam - s
suffix	suffix
frenzy	frenzy
whose	whose
hence	hence
hammers	hammer - s
brass	brass
bigger	bigger
accents	accent - s
nostalgia	nostalgia
truck-load	truck-load
stunned	stunned
became	be - c - ame
bothered	bother - ed
nest	nest
6079	6079
drinking-shops	drinking-shops
shifted	shift - ed
gasp	gasp
heavy	heav - y
snow	s - now
vow	vow
funeral	funeral
drenching	drench - ing
little	little
cowardice	cowardice
drawn-in	drawn-in
believed	believ - ed
clean	c - lean
observant	ob - servant
bicycle	bicycle
forefinger	fore - finger
pedantic	pedantic
sexless	sexles - s
conditioning	condition - ing
remembering	remember - ing
throat	throat
opinions	opinion - s
sweet	sweet
ordinary-looking	ordinary - -look - ing
committed	committ - ed
hockey-fields	hockey-field - s
fills	fill - s
amputated	amputat - ed
neolithic	neolithic
nib	nib
cheaper	cheap - er
normally	normal - ly
tribunal	tribunal
'ired	'ired
repression	repress - ion
twenty-two	twenty-two
wait	wait
tears	t - ear - s
glorious	glorious
attempt	attempt
organizing	organiz - ing
urinate	urinate
labyrinthine	labyrinthine
haggling	haggling
high	high
share	share
malignant	malignant
monster	monster
overpowering	overpower - ing
crucial	cruci - al
aristocracies	aristocrac - ies
4th	4th
english	english
reddened	re - dden - ed
light	light
wilful	wilful
gorn	gorn
wrap	w - rap
eminent	eminent
safeguards	safeguard - s
ordinary	ordinary
prevailing	prevailing
abusing	abus - ing
dying	dying
gangsters	gangst - er - s
external	external
size	s - ize
love-making	love-making
multifarious	multifariou - s
consisted	consist - ed
dickens	dickens
recognized	recogniz - ed
consists	consist - s
actuated	actuated
european	european
threading	thread - ing
discs	disc - s
day	day
surrendered	surrender - ed
draft	draft
view	view
grievances	grievances
unjust	un - just
hedge	h - edge
incredulous	in - credulous
solid	solid
chiming	chim - ing
dislocate	dislocat - e
leaving	leaving
curiosity	curiosity
blades	blade - s
japan	japan
markets	market - s
real	real
survive	surviv - e
swirl	swirl
skilfully	skilfully
table-tops	table-tops
bound	bound
sulkily	sulkily
smiles	s - mile - s
intentionally	in - tention - ally
win	w - in
all	all
suggestive	suggest - ive
father-to-son	father-to-son
lighter	light - er
schoolmaster	schoolmaster
squeezed	squeez - ed
contourless	contourless
marks	mark - s
caesars	caesar - s
clutching	clutch - ing
sensation	sensation
ruling	ruling
15	15
sought	s - ought
displeasure	dis - pleasure
strive	strive
mainly	main - ly
annihilated	annihilat - ed
stupid	stupid
centralized	central - ized
wrung	w - rung
yelled	yell - ed
desired	desire - d
evade	evade
disorder	dis - order
ears	ear - s
become	become
feeling	feel - ing
distributed	distribut - ed
accomplish	accomplish
outside	out - side
spectacles	spectacle - s
sub-section	sub-section
superseded	supersed - ed
rigidity	rigid - ity
ugly	ugly
stood	s - too - d
hardship	hard - s - hip
eastward	eastward
controlled	controll - ed
panic	panic
exploited	exploit - ed
piercing	pierc - ing
safeguard	safeguard
dribble	dribbl - e
butted	butt - ed
hurrying	hurry - ing
proceedings	proceed - ing - s
chessboard	chessboard
imaginable	imagin - able
sleepiest	sleep - ies - t
'ole	'ole
irresistible	irresistibl - e
educated	educat - ed
officer	offic - er
low	low
isles	isles
parsons	parsons
civilized	civil - ized
pitched	p - itch - ed
disquieting	dis - quiet - ing
weaker	weak - er
caption	c - aption
fetched	fetched
whereupon	whereupon
dirt	dirt
educational	educat - ion - al
d'	d'
decaying	decay - ing
sandy-haired	sandy-haired
disconnectedly	dis - connected - ly
reform	re - form
marking	mark - ing
spoke	spoke
pumped	pump - ed
that	t - hat
through	t - h - rough
dissemble	dis - semble
pictures	picture - s
preparing	prepar - ing
barriers	barrier - s
gratuitous	gratuitou - s
lid	lid
jailbird	jailbird
sorry	s - orry
predestined	predestined
aspect	a - spect
considered	consider - ed
flexibility	flexibility
din	din
while	while
devised	devise - d
exercise	exercis - e
hymn	hymn
dominion	dominion
pitch-dark	pitch-dark
daunted	daunted
interior	interior
ointment	ointment
schoolchildren	school - children
angle-joint	angle-joint
girl	girl
breathing	breath - ing
stack	s - tack
allow	allow
syllables	syllable - s
receive	receiv - e
crawled	crawl - ed
commander	command - er
skin	skin
jobs	job - s
calculate	calculat - e
employed	employed
pyramid	pyramid
sixteen	sixteen
twelve	twelve
burning	burn - ing
laughed	laugh - ed
decline	declin - e
sitting-room	sitting-room
rgime	rgime
clutch	clutch
shabby	shabby
showed	show - ed
hair	hair
imbecility	imbecil - ity
good-bye	good-bye
effects	effect - s
hands	hand - s
meet	meet
merit	merit
traitor	traitor
remained	re - main - ed
pretence	pretence
applause	applause
committees	committee - s
precious	precious
stagnant	stagnant
wicked	wicked
frequenting	frequent - ing
battering	batter - ing
patriotism	patriotism
phase	p - ha - s - e
heirs	heir - s
pharaohs	pharaohs
mentality	mental - ity
impatiently	im - patient - ly
legendary	legend - ary
oily	oil - y
smaller	s - m - all - er
incurious	in - curiou - s
might	might
much	much
lipsticked	lipstick - ed
smells	smell - s
russians	russian - s
announcement	announce - ment
organization	organiz - ation
weapon	weapon
walk	walk
door	door
attributes	attributes
pair	pair
wide	wid - e
exclamations	exclamations
count	count
my	my
aloud	a - loud
indispensably	indispensabl - y
derived	deriv - ed
office	offic - e
inapplicable	in - applic - able
introduction	introduct - ion
floorspace	floorspace
pity	pity
eats	eat - s
enacted	en - act - ed
india	india
sabotage	sabotage
table	t - able
convenient	convenient
asked	ask - ed
coin	coin
self-discipline	self- - discipline
cycle	cycle
pavement	pavement
vanishing	vanish - ing
suggests	suggest - s
restored	re - stor - ed
questioning	question - ing
eyeballs	eyeballs
charlemagne	charlemagne
arrived	arriv - ed
destructiveness	destructive - ness
boots	boot - s
efficiently	efficient - ly
extract	extract
heavily	heavi - ly
mocking	mocking
nothingness	nothing - ness
pamphlets	pamphlets
barman	barman
press	press
treated	treat - ed
composing	compos - ing
batch	b - atch
bore	b - ore
those	those
astrology	astrology
bottomless	bottom - less
sanity	sanity
cabinet	cabinet
rare	rare
jehovah	jehovah
marched	march - ed
perhaps	perhaps
'eard	'ear - d
ranges	rang - e - s
fist	fist
skill	s - kill
motive	motive
vomit	vomit
cavity	cavity
flagrant	flagrant
stubborn	stubborn
hostages	hostages
astronomy	astronom - y
prayer	prayer
orifices	orifice - s
acting	a - c - ting
occurred	occurr - ed
platform	platform
greenness	green - ness
smiled	s - mile - d
grab	grab
foreshadowed	foreshadowed
neutral	neutral
daily	daily
promises	promis - e - s
started	start - ed
falling	fall - ing
statues	statu - e - s
entail	entail
counted	count - ed
wrapping	wrapping
ipril	ipril
white-counterpaned	white-counterpan - ed
initial	initial
tumbled	tumbl - ed
oceans	ocean - s
states	s - t - at - e - s
unconscious	un - consciou - s
centimetre	centimetre
included	includ - ed
ark	ark
adore	adore
again	a - gain
cringing	c - ring - ing
coarseness	coarse - ness
civil	civil
fur	fur
everywhere	everywhere
overhead	overhead
pitch	p - itch
pleasant	pleasant
serve	serve
shoeless	shoeles - s
susceptible	susceptible
upside-down	upside-down
clearly	clear - ly
considerable	consider - able
bloated	bloated
geographical	geographical
imbecile	imbecil - e
'e	'e
manual	manual
researches	re - search - e - s
wings	wing - s
laughter	laughter
actors	act - or - s
admission	a - d - miss - ion
approval	approv - al
one-two	one-two
suit	suit
disappear	dis - appear
bashed	bashed
incidents	incident - s
packet	packet
imposture	imposture
watchful	watch - ful
decent	decent
porcelain	porcelain
crossed	cross - ed
fidgeted	fidget - ed
outlet	outlet
arbitrary	arbitrary
click	click
be	be
outlook	out - look
respites	respite - s
distinguishing	distinguish - ing
overfulfillment	overfulfill - ment
distorted	distort - ed
heroic	heroic
stairs	stair - s
pegging	pegging
workers	work - er - s
dinned	dinned
rank-and-file	rank-and-file
onwards	onwards
wayward	wayward
streaming	stream - ing
w.	w.
unforgivable	unforgivable
embrace	embrac - e
session	session
sad	sad
reasoned	reason - ed
chest	c - h - est
mild	mild
variation	variation
smudge	smudge
fumes	fum - e - s
ladling	ladl - ing
co-operating	co-operat - ing
oneself	oneself
resign	re - sign
willingness	willing - ness
venerated	venerate - d
stooped	stoope - d
eleventh	eleventh
created	creat - ed
fanatics	fanatic - s
misty	mist - y
quoting	quot - ing
unequal	un - equal
rid	rid
sink	s - ink
resentfully	re - sentful - ly
earmarked	earmark - ed
gradually	gradual - ly
market	market
revert	revert
syme	syme
testicles	testicles
whom	whom
butter	b - utter
backwards	backward - s
perilously	perilously
vicious	vicious
comprehended	comprehend - ed
abolition	abolit - ion
drudgery	drudgery
punishable	punish - able
encouraged	encourag - ed
sorrows	sorrow - s
rubbishy	rubbish - y
shapeless	shape - less
survives	surviv - e - s
directions	direct - ion - s
bunk	b - unk
unopposed	un - oppos - ed
hatching	h - atch - ing
thirst	thirst
hitched	h - itch - ed
australian	australian
industriousness	industrious - ness
relearn	re - learn
toiled	toil - ed
peacefully	peaceful - ly
shining	shin - ing
speedwise	speed - wise
sandwiches	sandwiches
trustworthy	trustworthy
flew	flew
top-storey	top-storey
conquest	conquest
assembled	assembl - ed
daren't	d - aren't
warmth	warmth
field	field
hole	hole
citizen	citizen
earthly	earthly
haunted	haunt - ed
toothless	tooth - less
'ouse	'ou - s - e
untouchables	un - touch - able - s
pacific	pacific
level-headed	level-head - ed
capital	capital
wariness	wariness
cynicism	cynicism
extinguish	extinguish
geological	geological
kind	kind
yesterday	yesterday
continents	continent - s
exaggerated	exaggerat - ed
fluttering	flutter - ing
leprosy	leprosy
indoctrinate	indoctrinate
such	such
sleepily	sleepily
waiters	wait - er - s
lavatory	lavator - y
terrified	terrifi - ed
chooses	choos - e - s
raised	rais - ed
homes	h - ome - s
flowering	flower - ing
recreation	recreation
involuntarily	in - voluntarily
crosspurposes	cross - purpose - s
grammatical	grammatical
reassuringly	reassur - ing - ly
lids	lid - s
oldfashioned	oldfashioned
abbreviated	abbreviat - ed
elaborate	elaborate
precision	precis - ion
shirking	shirk - ing
sixties	sixt - ies
chimed	chim - ed
formulate	formulate
sticky-eyed	sticky-ey - ed
shuddering	shudder - ing
sinecure	sinecure
lack	lack
lowered	lower - ed
stovepipe	stovepipe
shadow-world	shadow-world
sports-shirt	s - ports-shirt
degrees	degree - s
beseech	be - seech
enquiry	enquiry
characterize	characterize
conqueror	conquer - or
uncovered	un - cover - ed
place	plac - e
bright-lit	b - right-lit
discovering	dis - cover - ing
forming	form - ing
undo	undo
instrument	instrument
confused	confus - ed
crinkle	c - rinkle
gents	gent - s
moulding	mould - ing
halfhearted	halfhearted
accompany	accompany
considerations	consider - ation - s
espionage	espionage
brazilian	brazilian
belt	bel - t
level	level
inconceivable	in - conceivable
staccato	s - taccato
imperial	imperial
noise	noise
turf	turf
mass	mass
outraged	outrag - ed
victories	victor - ies
dark-coloured	dark-coloured
reverberation	reverberat - ion
province	province
taking	t - aking
lock	lock
trembling	trembling
facecrime	facecrime
shirt	s - hirt
questions	question - s
development	develop - ment
immediate	immediate
truckload	truckload
winter	winter
'yde_park	'yde_park
admitting	admitt - ing
cheek	cheek
curtain	curtain
moss	mos - s
minutes	minute - s
outweighed	outweighe - d
sir	s - ir
tauter	tauter
gang	gang
dashed	dash - ed
lymph	lymph
obeying	obey - ing
owe	ow - e
purposes	purpose - s
unsteadily	un - steadily
hinted	hint - ed
raids	raid - s
tended	t - end - ed
recesses	r - ecesses
textbooks	textbook - s
churches	church - e - s
speculative	speculative
offensive	offensive
guarding	guard - ing
parents	parent - s
systems	s - ystem - s
uninteresting	un - interest - ing
sheep-face	s - heep-face
propositions	pro - position - s
spiritless	spirit - less
police	polic - e
dealing	deal - ing
different	different
gripped	gripp - ed
obeyed	obey - ed
capacity	capacity
sixty	sixt - y
smooth	smooth
slammed	s - lammed
wall	w - all
indonesian	in - donesian
terribly	terribl - y
illustration	illustrat - ion
recuperate	recuperate
distribution	distribut - ion
dog	dog
gorilla-faced	gorilla-faced
page-ends	page-end - s
furiously	furious - ly
hero	hero
loyalty	loyalty
edges	edge - s
disappointing	disappoint - ing
fluttered	flutter - ed
exit	exit
middle-sized	middle-sized
apex	apex
stew	stew
vistas	vistas
unmasked	un - mask - ed
absurd	absurd
minute	minute
interfered	interfer - ed
irresistibly	irresistibl - y
accidental	accident - al
novels	novel - s
statements	statement - s
uselessly	useless - ly
nitric	nitric
torpedo	torpedo
own	own
convoluted	convoluted
ghostlike	ghost - like
succumbing	succumb - ing
iii	iii
noticing	noticing
overcome	overcome
byron	byron
grass	gras - s
carried	c - arried
hideously	hideou - s - ly
paid	pai - d
adam	adam
burying	burying
cowardly	coward - ly
handful	hand - ful
suppress	suppress
overthrown	overthrow - n
principal	principal
saviour	saviour
screamed	scream - ed
black-haired	black-hair - ed
first	fir - s - t
floor	floor
scientist	scientist
shore	s - hore
pretty	p - re - tty
suppose	suppos - e
lists	list - s
screaming	scream - ing
mathematical	mathematical
carpet	carpet
filthiest	filthi - est
hopefully	hopefully
persecuted	persecut - ed
armour-plating	armour-plating
woken	woke - n
engine	engine
carriages	carriage - s
clerks	clerks
reformers	re - form - er - s
half-nostalgically	half-nostalgically
ill-paid	ill-paid
pan	p - an
ruby	rub - y
tableaux	tableaux
wass	was - s
plunge	plung - e
analogies	analogies
reckoned	re - ckon - ed
comes	c - ome - s
egypt	egypt
defeating	defeat - ing
focusing	focus - ing
life	life
luridly	luridly
hearth-stone	hearth-stone
rebelling	re - bell - ing
toilet	toilet
appeared	appear - ed
planning	plann - ing
vital	vital
mysterious	mysterious
bareness	bareness
studying	study - ing
averted	avert - ed
truncheon	truncheon
streetlevel	s - treetlevel
his	his
measured	measur - ed
brooches	brooche - s
molehill	molehill
orators	orator - s
thousandth	thousand - th
habit-forming	habit-form - ing
americans	american - s
disseminate	disseminate
successfully	success - ful - ly
despatches	despatche - s
policy	polic - y
retaliation	retaliation
rigid	rigid
screwed	screw - ed
teacupful	teacup - ful
well-known	well-known
laws	law - s
overwhelming	overwhelm - ing
acquire	acquir - e
magnificent	magnifi - cent
conceivable	conceivable
penitent	penitent
party	part - y
plausible	plausibl - e
mountain	mountain
sufficiently	sufficient - ly
i.e.	i.e.
unsaid	un - said
yielding	yield - ing
aloofness	aloofness
anchored	anchored
smashing	smash - ing
granddaughter	grand - daughter
brown	b - rown
apparent	apparent
chattering	c - hattering
remembered	remember - ed
rocket	rocket
reverted	revert - ed
accumulation	accumulat - ion
squealing	squeal - ing
documentation	document - ation
drop	drop
garden	garden
merge	merge
cheesy	chees - y
reaction	re - action
sniff	sniff
happen	happen
auxiliary	auxiliary
feral	fer - al
torment	torment
welling	well - ing
report	report
brawny	b - rawny
scrounging	s - croung - ing
down	d - own
skipped	s - kipped
plentiful	plentiful
bishops	bishops
urinal	urin - al
question	question
dried	dri - ed
drawed	draw - ed
refrained	refrain - ed
chisels	chisel - s
primitive	primit - ive
closing-time	closing-time
liberated	liberate - d
forty-five	forty-five
plain	plain
annihilate	annihilat - e
risk	risk
ugliness	ugliness
fallacy	f - allacy
emerged	emerge - d
adoptive	adopt - ive
infallible	infallible
piles	pile - s
boggy	boggy
sting	s - ting
movements	movement - s
enjoy	enjoy
unsatisfying	un - satisfy - ing
outer	out - er
enormity	enormity
instincts	instinct - s
strategic	s - trategic
popularity	popular - ity
knowing	know - ing
poorer	poor - er
tens	tens
tobacco	tobacco
fail	fail
conception	concept - ion
impossible	im - possible
pay-out	pay-out
tap	t - ap
altered	alter - ed
'm	'm
camps	camp - s
city	c - it - y
fecundity	fecundity
alien	alien
leg	leg
pleased	please - d
beautiful	beauti - ful
enter	enter
posters	post - er - s
ante	ante
admiration	admiration
unknowns	unknown - s
disobedience	dis - obedience
reducing	reduc - ing
re-learn	re- - learn
remarks	remark - s
judgements	judgement - s
wad	wad
softening	s - often - ing
smoking	smok - ing
bombardment	bombard - ment
sprawling	s - prawling
capable	capable
original	original
snatching	snatch - ing
tonight	t - onight
years	year - s
permit	permit
associates	associates
brink	brink
yield	yield
knight	knight
bellies	bell - ies
brick-red	brick-red
principle	principle
terrific	terrific
loud	loud
apathetic	apathetic
borne	born - e
communicate	communicat - e
cellars	cellar - s
communist	communist
inflicting	inflict - ing
thinkable	thinkable
pronounce	pronounce
lord	lord
bringing	b - ring - ing
pipe	pipe
armies	armie - s
especially	especial - ly
fast	fast
music	music
sanguine	sanguine
subtlety	subtlety
mistaken	mistake - n
spoon	spoon
armchair	armchair
completed	complete - d
layer	lay - er
son	s - on
likewise	likewis - e
ipso_facto	ipso_facto
seventeen	seventeen
scene	s - c - en - e
nimbly	nimbly
quantities	quantitie - s
ogilvy	ogilvy
hideous	hideou - s
individual	individual
remain	re - main
dials	dial - s
gesticulating	gesticulat - ing
absurdity	absurd - ity
oldthink	oldthink
equally	equal - ly
copied	copi - ed
purposive	purposive
territories	territor - ies
splendid	splendid
stiff	stiff
sweating	sweat - ing
essential	essential
approach	approach
bag	bag
fullwise	fullwise
watery	water - y
confession	confess - ion
between	be - tween
domination	dominat - ion
marx	marx
messages	message - s
portions	portion - s
discomfort	dis - comfort
empire	empire
appealed	appeal - ed
olden	old - en
divorce	divorce
revolt	revolt
officially	official - ly
middle	middle
technological	technolog - ical
aback	a - back
nut	nut
routes	rout - e - s
progress	progress
morally	moral - ly
swiftly	swift - ly
cherry-coloured	cherry-coloured
racketeering	racketeer - ing
beetle-like	beetle - -like
irrationally	irrationally
class	class
argument	argument
tight	tight
charged	charge - d
coarsely	coarse - ly
dulled	dull - ed
mark	mark
peculiarly	peculiar - ly
strongest	strong - est
marching	march - ing
folly	folly
but	but
sexual	sexual
rival	rival
shocked	shock - ed
sociologists	sociologists
tricks	trick - s
living	living
unbent	un - b - ent
intermittent	intermittent
dictate	dictat - e
irritating	irritat - ing
rather	rather
maddened	madden - ed
'er	'er
naked	naked
monument	monument
rations	ration - s
seemed	seem - ed
offer	offer
concentration	concentrat - ion
comma	comma
sound-track	s - ound-track
smuggled	smuggle - d
pin	p - in
passion	pass - ion
rendezvous	rendezvous
remind	re - mind
sooty	sooty
stripping	s - t - ripping
recrossing	re - cross - ing
terrible	terribl - e
ill-omened	ill-omen - ed
afford	afford
tangier	tangier
period	period
inflame	in - flame
register	register
limits	limit - s
interspersed	interspers - ed
convey	convey
readiness	readi - ness
cylinder	cylinder
shirk	shirk
decided	decid - ed
bending	b - ending
displays	dis - play - s
politics	p - olitic - s
ancient	ancient
opposite	opposit - e
generations	generation - s
underworld	un - derworld
regulated	regulat - ed
rejects	reject - s
set	set
bough	bough
suggested	suggest - ed
perceptible	perceptibl - e
direct	direct
rooms	room - s
loyal	loyal
threes	three - s
links	link - s
ownlife	ownlife
believe	believ - e
energy	energy
fading	f - ading
balancing	balanc - ing
cooking	cook - ing
fingering	finger - ing
citizens	citizen - s
living-room	living-room
kicking	kick - ing
planet	planet
cheeks	cheek - s
misunderstanding	mis - understand - ing
sequel	sequel
devotees	devotees
friends	friend - s
oilstove	oilstove
tempo	tempo
utopias	utopia - s
validity	validity
clumsily	clumsily
stratum	stratum
fullest	full - est
carefree	carefree
clump	c - lump
cried	cri - e - d
imprisonments	imprisonment - s
mongolia	mongolia
altogether	a - l - together
buggers	buggers
call	call
subscriptions	subscriptions
indefinitely	in - definite - ly
nerve	nerve
shriek	s - hriek
tiny	t - in - y
dwelt	dwelt
dream	dream
fiftyseven	fiftyseven
still-popular	still-popular
twist	twist
copying	copy - ing
whined	whin - ed
anxiety	anxiety
finish	finish
respect	re - spect
clothes	cloth - e - s
nobody	nobody
never-questioned	never-questioned
grammes	grammes
personal	person - al
commemorate	commemorat - e
differed	differed
blackmail	blackmail
shorten	shorten
compensation	compensation
psychologist	psychologist
drank	d - rank
hand	hand
civilizations	civilization - s
eggs	eggs
immensely	immense - ly
largely	large - ly
nevertheless	neverthele - s - s
mayor	mayor
fair	fair
darling	darl - ing
demonstrative	demonstrat - ive
battlefield	battlefield
evil	evil
goldsteinism	goldstein - ism
play	play
savings	s - aving - s
gripping	gripp - ing
impending	im - p - ending
specific	s - pecific
voice	voice
uncover	un - cover
corridor	corridor
facts	f - act - s
understood	un - derstood
expend	expend
belched	belch - ed
staying	stay - ing
inflexion	inflexion
ribs	rib - s
inextricably	inextricably
rest	rest
delight	delight
engaged	engag - ed
betray	betray
clot	c - lot
contracted	contracted
ineffectual	ineffectual
reasons	reason - s
debauchery	debauch - er - y
adding	adding
solitary	solitary
wearied	weari - ed
spectacle-flash	s - pectacle-flash
panics	panic - s
poetry	poetry
asking	a - s - king
peeling	peeling
defend	defend
great-grandmother	great-grandmoth - er
waged	w - age - d
cost	c - ost
assume	assume
waking	w - aking
interrogating	interrogat - ing
swing	s - wing
stir	s - tir
bounded	bound - ed
sympathetically	sympathetic - ally
strolled	stroll - ed
colonial	colonial
yes	ye - s
ducked	duck - ed
anyone	anyone
saliva	saliva
loosestrife	loosestrif - e
film	film
swarming	s - warm - ing
moreover	moreover
modern	modern
tomorrow	t - omorrow
cells	c - ell - s
jargon	jargon
upon	upon
countries	countrie - s
valued	value - d
rasped	rasp - ed
popped	popp - ed
fussy	fus - s - y
idea	idea
three	three
sunken	s - unken
progressive	progress - ive
battered-looking	battered - -look - ing
action	action
businesslike	business - like
miniplenty	mini - plenty
mastodons	mastodons
busy	b - us - y
forces	forc - e - s
meaning	mean - ing
caricaturist	caricaturist
minds	mind - s
suspicious	s - uspiciou - s
troop	troop
complex	complex
self-destruction	self- - destruction
languages	language - s
everyday	everyday
proper	proper
mirrored	mirror - ed
quality	quality
marked	mark - ed
portugal	portugal
nouns	noun - s
claim	claim
coolness	coolness
seven	s - even
right	right
blissful	bliss - ful
dwarf	dwarf
eighty	eight - y
flickered	flicker - ed
tribute	tribute
insect	in - sect
presence	presence
frank	frank
longing	long - ing
female	female
wires	wire - s
pointing	point - ing
lacquered	lacquer - ed
bb	bb
improvisation	improvis - ation
deceiving	deceiv - ing
century	centur - y
noses	noses
signal	sign - al
sluttish	sluttish
translating	translat - ing
aquiline	aquiline
they	they
try	try
closebitten	closebitten
discrimination	dis - criminat - ion
thou	thou
didnt	didnt
practitioners	practitioner - s
101	101
odious	odious
fight	fight
matches	matche - s
indirect	in - direct
unperson	un - person
lowest	lowest
casually	casually
smart	smart
wallop	wallop
patrol	patrol
remaining	remain - ing
heaved	heav - ed
alibi	alibi
private	private
triumph	triumph
distraction	dis - t - raction
thinkpol	thinkpol
seeing	seeing
yellow	yellow
appropriate	appropriat - e
cent	cent
pistol	pistol
northern	northern
penetrating	penetrat - ing
inscriptions	inscription - s
outflank	out - flank
impudent	impudent
promised	promis - ed
boiled	boil - ed
crisis	crisi - s
detachments	detachments
latest	late - s - t
bottle-stopper	bottle-stoppe - r
harshly	harsh - ly
couldn't	c - ouldn't
pouring	pour - ing
re-edit	re-edit
jewess	jewe - s - s
mental	mental
simply	simpl - y
vestibule	vestibule
arrests	arrest - s
pole	pole
preferred	p - referr - ed
pacing	p - acing
swaying	s - w - aying
inherent	inherent
constant	constant
scrutinized	scrutinized
submarine	submarine
valet	valet
wrist-watch	wrist-watch
tune	tune
selfish	selfish
agate	a - gate
bird	bird
morsel	morsel
blossoming-period	blossoming-perio - d
medium	medium
name	name
spectacle	spectacle
combatants	combatants
verging	verging
rung	rung
clean-mindedness	clean-mindednes - s
boasted	b - oast - ed
present	present
morality	morality
danes	d - anes
labour-camp	labour-camp
race	race
atrocity	atrocit - y
labyrinth	labyrinth
eradicate	eradicate
chaucer	chaucer
belonged	belong - ed
es	es
past	past
implication	implicat - ion
principles	principle - s
3	3
denies	deni - e - s
sensational	sensation - al
homosexuality	homosexuality
shove	shov - e
belfry	belfry
desire	desire
pugnaciously	pugnaciously
wildly	wild - ly
caught	c - aught
title-page	title-page
undermines	undermine - s
disgustedly	disgust - ed - ly
flitted	flitt - ed
dare	dare
calls	call - s
weakness	weaknes - s
art	art
seats	s - eat - s
emptied	empti - ed
originally	original - ly
rich	rich
mob	mob
cargo-ships	cargo-ship - s
committee	committee
patiently	patient - ly
jowl	jowl
window-pane	window-pane
destruction	destruction
independence	in - depend - ence
create	creat - e
kinds	kind - s
permanence	permanence
encircling	encircl - ing
dismay	di - s - may
tapping	tapp - ing
nests	nest - s
ailing	ailing
annoyance	annoyance
hysteria	hysteria
greycoloured	greycolour - ed
quailed	quail - ed
lootings	loot - ing - s
malreported	mal - report - ed
exaltation	exaltation
false	false
guards	guard - s
dreamy	dream - y
dull	dull
feebly	feeb - ly
lackeys	lackeys
london	london
midsentence	mid - sentence
receded	re - ced - ed
illusions	illusion - s
rotten	rott - en
barbed-wire	barbed-wire
scratched	scratch - ed
smell	smell
drudges	drudge - s
joints	joint - s
mutilating	mutilat - ing
lives	live - s
sexuality	sexual - ity
ruler	rul - er
ancestors	ancestor - s
soluble	solubl - e
blow	b - low
sexcrime	s - excrime
stepped	stepp - ed
equivocation	equivoc - ation
whitestubbled	w - hitestubbl - ed
shoreditch	shoreditch
leopoldville	leopoldville
africa	africa
sorrowful	sorrow - ful
offering	offer - ing
sewing-thread	sewing-thread
varies	vari - e - s
value	value
dividing	divid - ing
technically	technical - ly
hockey	hockey
ration	ration
perishes	perish - e - s
getting-up	getting-up
heaps	heap - s
uncontrollably	un - controll - ably
ruled	rul - ed
crudest	crude - s - t
rush	rush
fine	fine
periodical	periodical
amputate	amputat - e
dono	dono
betrayal	betrayal
commotion	commotion
crises	c - rise - s
industrious	industrious
justification	justifi - cation
agitation	agitat - ion
forgiveness	forgive - ness
shop	s - hop
streamers	stream - er - s
contemplated	contemplat - ed
court	court
hybrid	hybri - d
forgery	forger - y
diminishing	diminish - ing
like	like
gymnasium	gymnasium
inexhaustible	inexhaustibl - e
kick	kick
answerable	answer - able
ain't	ain't
shan't	shan't
crept	crept
amalgam	amalgam
ways	way - s
tossed	tossed
modify	modify
rain	rain
unquestioning	un - question - ing
activities	activit - ies
includes	includ - e - s
deal	deal
startled	startl - ed
jerkily	jerkily
prestige	prestige
solidarity	s - olidarity
sub-committee	s - ub-committee
bet	be - t
groups	group - s
closely	closely
england	england
peaceful	peaceful
speaks	speak - s
consciousness	consciou - s - ness
locks	lock - s
gathered	gather - ed
goat	goat
leisure	leisure
spelling-book	s - pelling-book
achievements	achievement - s
oligarchies	oligarch - ies
existence	exist - ence
possessed	possess - ed
withers	with - er - s
ages	age - s
demoralization	demoraliz - ation
master	master
kettle	kettle
meantime	meantime
accepting	accept - ing
untruthful	un - truthful
demonstrating	demonstrat - ing
suited	suit - ed
crazy	crazy
ungood	un - good
writing-table	writing-t - able
designing	design - ing
gateleg	gateleg
golden	golden
cube	cube
provisional	pro - vision - al
assassination	assassination
stamping	stamp - ing
household	household
green-shaded	green-shaded
impounded	im - pound - ed
seriously	serious - ly
ran	ran
jewish	jewish
helps	help - s
ratholes	rathole - s
wrong-doing	wrong-doing
eight	eight
steel	s - teel
83	83
strange	s - t - rang - e
seduction	seduction
air-raids	air-raids
shaped	shape - d
unnoticed	un - notice - d
examples	example - s
schoolmasterish	schoolmaster - ish
and	an - d
passageway	passage - way
temple	temple
outnumbering	out - number - ing
cheat	c - heat
specially	special - ly
rifles	rifle - s
recover	re - cover
twenty-three	twenty-three
well-timed	well-timed
then	t - hen
borrow	borrow
focused	focus - ed
put	put
extremely	extreme - ly
laugh	laugh
overlordship	overlordship
tightened	tight - en - ed
puddles	puddle - s
metal	met - al
gilded	gild - ed
intellectual	intellectual
ideal	ideal
intellectuality	intellectual - ity
moved	move - d
grease	greas - e
half-hour	half-hour
silliness	s - illines - s
gulped	gulp - ed
consisting	consist - ing
junior	junior
totalitarian	totalitarian
moving	m - oving
weaklings	weaklings
indignation	indign - ation
abiding	abid - ing
launched	launched
credulous	credulous
triumphing	triumph - ing
nudging	nudg - ing
humiliate	humiliat - e
profited	profited
valuable	valuable
]	]
caterpillars	caterpillars
red-armed	red-armed
rickety	rickety
ink	ink
lunch	lunch
very	very
defeat	defeat
competition	c - ompetition
cowards	coward - s
gazing	gazing
loins	loin - s
checked	check - ed
reinstated	re - in - stated
rope	rope
sure	sure
wild-rose	wild-rose
plucked	p - luck - ed
grounded	ground - ed
strong	strong
lagged	l - agged
bump	bump
cream-papered	cream-papered
among	among
freely	free - ly
represented	re - present - ed
soaring	soaring
exhortations	exhortations
dayorder	day - order
corresponding	corresponding
improving	improv - ing
puts	puts
recreated	re - creat - ed
save	save
unanswered	un - answer - e - d
factories	factor - ies
rules	rul - e - s
indecipherable	indecipherable
uncold	un - cold
capitulated	capitulate - d
longer	long - er
spooned	spoon - ed
dearest	dearest
tolerant	tolerant
faltered	f - alter - ed
hammering	hammer - ing
performed	performed
lump	lump
speedful	speed - ful
mouthful	mouthful
millions	million - s
pervert	perv - er - t
straggled	straggl - ed
stumbled	s - tumbl - ed
talking	talk - ing
consciously	consciou - s - ly
wearing-down	w - earing-down
humand	human - d
floors	floor - s
spasm	spasm
aims	aim - s
continuing	continu - ing
significant	significant
postcards	postcards
act	act
recurs	re - cur - s
savage	savage
squeeze	squeez - e
offence	offence
nodded	nodd - ed
heave	heav - e
russian	russian
bad	bad
horrify	horrify
exciting	excit - ing
elegant	elegant
steady	stead - y
stiffened	stiffen - ed
coming	coming
outline	outline
hallway	hallway
'ad	'a - d
speakwritten	speak - written
super-state	super-state
abject	abject
public	public
suits	suit - s
gas	gas
technicians	technician - s
excitement	excit - e - ment
mess	me - s - s
aristocracy	aristocrac - y
careless	careless
losing	losing
thoughtcriminals	thought - criminal - s
logical	logic - al
forerunners	forerunners
shutter	s - h - utter
complaining	complaining
show-pieces	show-piece - s
tails	tail - s
month	month
depends	depend - s
wife	wife
urine	urin - e
apron	apron
ask	ask
bleat	bleat
assumed	assumed
disposal	dispos - al
adoration	a - d - oration
skirt	s - kirt
wrote	w - rot - e
over'ead	over'ead
hiding-places	hiding-place - s
watches	watch - e - s
lessons	lesson - s
celibacy	celibacy
gift	gift
morning	morning
pressed	press - ed
punished	punish - ed
cubic	c - ubic
plan	plan
benefit	benefit
tables	t - able - s
urgent	urgent
wrenches	wrench - e - s
interfering	interfer - ing
blackberry	blackberr - y
dampness	dampnes - s
derisive	derisive
modes	modes
pressing	press - ing
enormous	enormous
moloch	moloch
dissent	dis - sent
planes	plan - e - s
upset	upset
inferiors	inferior - s
proclaiming	proclaim - ing
answering	answer - ing
replaced	re - plac - ed
sub-editors	sub-editors
developed	develop - ed
frantically	frantic - ally
concave	concave
regretful	regretful
feel	feel
racing	racing
accidental-like	accident - al - -like
floats	float - s
dropped	dropp - ed
sick	s - ick
white	white
feature	feature
genuine	genuine
silent	silent
trumpet	trumpet
sleeplessness	sleep - less - ness
intrigues	intrigue - s
dilapidated	dilapidated
leading	lead - ing
alterable	alterable
cares	car - e - s
effigy	effigy
attract	attract
ending	ending
enema	enema
inscrutable	inscrutable
love-offering	love-offering
eighteenth-century	eighteenth-century
physical	physical
inkstained	inkstain - ed
plumping	p - lump - ing
gangs	gang - s
poison	poison
refilled	re - fill - ed
scuttle	s - cuttl - e
organized	organiz - ed
waving	w - aving
poured	pour - ed
creamy	creamy
ease	ease
reverberating	reverberat - ing
wake	w - ake
crumbled	crumbl - ed
impassively	impassive - ly
biting	bi - ting
describe	describ - e
steam	s - team
threat	threat
fighting	fight - ing
downhill	downhill
faint	faint
therefore	therefore
rightly	right - ly
dupes	dupes
maintained	maintain - ed
stain	s - tain
dignity	dignity
betrayed	be - tray - ed
drowned	drown - ed
uncomfortably	uncomfortably
abbreviations	abbreviat - ion - s
unrepentant	unrepentan - t
felt	felt
enemies	enemie - s
tablets	tablet - s
think	think
overwork	overwork
sneak	sneak
quota	quota
transparency	transparency
carriage	carriage
tips	tip - s
tirelessly	t - ireless - ly
larger	large - r
ablest	able - s - t
springing	spring - ing
multitude	multitude
recovered	re - cover - ed
motor-cars	motor-car - s
practices	practic - e - s
desultorily	desultori - ly
reverence	rever - ence
interlude	interlude
chaos	chao - s
comprises	comprises
international	international
superfluous	superfluous
flavoured	flavoured
object	object
schooldays	school - day - s
splinters	s - plinter - s
in	in
disdainfully	disdainfully
appreciate	appreciat - e
ideologically	ideological - ly
dumped	dump - ed
dark	dark
recalling	re - call - ing
sensuality	s - ensuality
greeted	greet - ed
loneliness	lonelines - s
waves	wave - s
massing	mass - ing
an	an
plugged	p - lugged
spinal	spin - al
spanners	spanner - s
paraphernalia	paraphernalia
holy	holy
manage	manag - e
inflect	inflect
bulging	bulg - ing
slumped	s - lump - ed
compose	compos - e
dodged	dodge - d
drinks	drink - s
satisfies	satisfi - e - s
crushed	c - rush - ed
mighty	might - y
parts	part - s
waistline	waistline
seventeen-twenty	seventeen - -twenty
doings	doing - s
product	product
beam	beam
eddies	eddie - s
safest	safe - s - t
issued	issu - ed
woke	woke
beans	bean - s
flogged	flogg - ed
innocence	innocence
linger	linger
stumpy	stump - y
dangerous	danger - ous
breeds	breed - s
unorthodox	un - orthodox
proles	prole - s
influence	influenc - e
hurl	hurl
levitation	levitation
imperfectly	im - perfect - ly
studied	s - tudi - ed
vocabulary	vocabular - y
frivolity	f - rivolity
wiped	wip - ed
ancestral	ancestral
waists	waist - s
sailors	sailor - s
submerged	submerged
causes	cause - s
disengage	disengage
dustbins	dustbins
embed	embed
camouflage	camouflage
irritably	irritably
tops	top - s
99	99
swiftly-moving	swiftly-moving
there	t - here
gyroscope	gyroscope
unwilling	un - willing
yellow-faced	yellow-fac - ed
fever	f - ever
magenta	magenta
expending	expend - ing
simpler	simpler
getting	getting
month-old	month-old
etc.	etc.
instruction	instruction
predict	predict
snatched	snatch - ed
indefatigably	indefatigabl - y
dirty-mindedness	dirty-mindedness
martial	martial
encountered	encounter - ed
commodity	commodity
untidy	untidy
debauch	debauch
could	coul - d
touching	touch - ing
methods	method - s
exception	exception
able	able
because	be - cause
reassurance	reassur - ance
proclamation	proclamation
upward	upward
cult	cult
slender	slender
superstates	superstate - s
sour	s - our
endorsed	endorsed
late	late
cheap	c - heap
likened	likened
visited	visit - ed
analysing	analys - ing
passport	passport
semblance	semblance
resulting	result - ing
photographs	photograph - s
antique	antique
implicate	implicat - e
looted	loot - ed
large	large
cure	cur - e
foresaw	f - oresaw
lecture	lecture
'eart-strings	'eart-strings
empirical	empirical
aim	aim
worked-out	worked-out
chanted	chant - ed
differences	difference - s
inside	in - side
one	one
reclamation	r - eclamation
buildings	build - ing - s
solution	solution
cents	cent - s
deleting	delet - ing
mattered	matter - ed
files	files
inquisitor	inquisit - or
did	did
trumpet-call	trumpet-call
shattering	s - hattering
potato	potato
afternoons	afternoon - s
extricate	extricate
niggling	niggling
straight	straight
guesswork	guesswork
(	(
mean-looking	mean-look - ing
thirties	t - hirt - ies
footstep	footstep
security	secur - ity
release	releas - e
vulgar	vulgar
walls	w - all - s
lightly	light - ly
demeanour	demeanour
liked	like - d
choosing	choos - ing
conferred	conferr - ed
thoughtfully	thought - ful - ly
strand	strand
scuffles	scuffles
enormously	enormous - ly
forecasts	forecast - s
deep	deep
marriages	marriage - s
softpalmed	softpalmed
trusted	trust - ed
blackness	blackness
obliquely	oblique - ly
shoes	shoe - s
authoritative	authoritative
bolster	bolster
gently	gent - ly
midnight	mid - night
poem	poem
goodthinked	goodthink - e - d
smile	s - mile
toes	toe - s
fortress	fortress
scrawny	scrawny
house-front	house-front
raid	raid
everyone	everyone
assault	assault
acrid-smelling	acrid-smell - ing
brief-case	brief-case
gunsights	gunsights
perpetuating	perpetuat - ing
seconds	second - s
by	by
contemptuous	contemptuous
self-confidence	self- - confidence
vaporizations	vaporiz - ation - s
park	p - ark
happy	happy
tried	tri - ed
crimethink	crimethink
inexorably	inexorab - ly
scent	s - cent
plunged	plung - ed
rubber	rubb - er
power	power
spaces	s - pace - s
twinge	t - wing - e
kindly	kind - ly
convicting	convict - ing
frightful	frightful
bludgeon	bludgeon
deprecating	deprecat - ing
leaning	lean - ing
packing	pack - ing
phrases	phrase - s
justly	just - ly
flood	flood
shrubs	shrubs
produce	produc - e
alive	a - live
approved	approv - ed
insidious	in - sidious
damn	damn
swap	swap
rectify	re - c - tify
proving	prov - ing
whistled	whistl - ed
opened	open - ed
allusion	allusion
straighter	straight - er
often	often
selling	selling
behaviour	behaviour
obey	obey
pillory	pillory
weekly	week - ly
bastards	bastards
scuttling	s - cuttl - ing
devastating	devastating
lest	l - est
racial	racial
render	render
texture	texture
flagstones	flagstones
tradesman	tradesman
bonds	bonds
debated	debat - ed
emotions	emotion - s
illiteracy	illiteracy
would	w - oul - d
shirts	s - hirt - s
filtering	filter - ing
contents	content - s
quill	quill
acts	act - s
temperature	temperature
cigarette	cigarette
healthier	healthier
hour	hour
dripped	d - ripped
bother	bother
thing	thing
antarctic	antarctic
indefinite	in - definite
prostitution	prostitution
detailed	detail - ed
suitably	s - uitab - ly
it	it
enough	enough
hysterically	hysterically
shapeliness	shapelines - s
saccharine	saccharine
armed	arm - ed
opposites	opposit - e - s
proved	prov - ed
conquer	conquer
looser	loos - er
pre-revolutionary	p - re- - revolutionary
treachery	treacher - y
fiddling	fiddling
contradicted	contradict - ed
encircled	encircl - ed
periodicals	periodical - s
tormented	torment - ed
intoxicating	intoxicat - ing
fifteen	fifteen
savages	savage - s
responsible	responsible
capering	capering
unseen	un - see - n
trolleys	trolleys
distinct	distinct
guv'nor	guv'nor
rolling	roll - ing
suppressed	suppress - ed
self-evident	self- - evident
coherent	coherent
jerky	jerk - y
practice	practic - e
teachings	teach - ing - s
persist	persist
transmitted	transmitt - ed
continue	continu - e
eyebrows	eyebrows
immortal	im - mortal
examination	examin - ation
murmurous	murmur - ous
tingling	t - ingl - ing
wrenched	wrench - ed
moments	moment - s
clasping	clasp - ing
rag	rag
mortally	mortal - ly
clanged	clang - ed
thrown	throw - n
disproved	dis - prov - ed
american	american
now	now
information	in - formation
relationships	relationships
point	point
ruinous	ruinou - s
abnormality	abnormality
materialized	material - ized
mechanically	mechanic - ally
texts	texts
formed	form - ed
push	push
varicose	varicose
diseases	dis - ease - s
national	nation - al
manufactured	manufacture - d
ruggedly	rugged - ly
sticky	stick - y
relays	re - lay - s
stroked	stroke - d
weaken	weak - e - n
creatures	creature - s
select	select
boys	boy - s
air-conditioned	air- - condition - ed
countryside	countryside
distinctions	distinct - ion - s
collectivization	collectivization
ruins	ruin - s
ju	ju
successors	success - or - s
club	club
stuffed	stuff - ed
booklets	booklets
dingy	dingy
delivered	deliver - ed
nervously	nervous - ly
antiseptic	antiseptic
join	join
villainous	villainous
uncured	uncured
non-political	non-political
wood	wood
supplied	supplied
gallon	gallon
hear	hear
tragic	tragic
greater	great - er
commonly	common - ly
adopted	adopt - ed
indeed	in - deed
clots	c - lot - s
trampled-on	trampled-on
feminine	feminine
phraseology	phraseology
antiques	antique - s
hebrew	hebrew
give	give
civilians	civilians
paper-clip	paper-clip
really	real - ly
radio	radio
sitting	sitt - ing
undergone	undergone
species	speci - e - s
show	show
numerous	numerou - s
stove	stove
disgusting	disgust - ing
melted	melt - ed
complicate	complicate
mate	mat - e
incapable	in - capable
sidelong	s - idelong
periods	period - s
adjust	adjust
forearms	forearm - s
blankets	blanket - s
rotund	rotund
chap	c - h - ap
undisputed	un - disputed
remarkable	remark - able
uniform	uniform
gnawing	gnawing
recognize	recogniz - e
vain	vain
network	network
readily	readi - ly
zip	zip
clung	c - lung
drink	drink
cries	cri - e - s
lifts	lift - s
speakwrite	speakwrite
distances	distance - s
sky	sky
sticking-plaster	sticking-plaster
unexpectedly	un - expect - ed - ly
interpose	interpose
sebastian	sebastian
arms	arm - s
offensively	offensive - ly
must	must
paraded	parad - ed
wreck	wreck
perceive	perceiv - e
gulfs	gulfs
disposing	dispos - ing
overfulfilled	overfulfill - ed
racketeers	racketeer - s
assign	a - s - sign
three-hour	three-hour
mealtimes	mealtimes
titular	titular
practic	practic
subdivided	subdivide - d
sessions	session - s
sometimes	sometimes
frame	fram - e
attachment	attach - ment
wavers	wave - r - s
primary	primary
kaleidoscope	kaleidoscope
retrace	re - trace
workings	work - ing - s
capitulate	capitulate
upside	up - side
strength	strength
agony	agony
classes	class - e - s
dressing	dress - ing
striding	s - t - riding
sane	sane
fifties	fiftie - s
met	met
recurred	recurr - ed
thirty-nine	thirty-nine
swine	s - wine
excelled	excell - ed
softened	s - often - ed
refer	re - fer
cyst	cyst
iceland	ice - land
interest	interest
credulity	credulity
shortlived	shortliv - ed
newspaper	newspaper
drowning	drown - ing
dance	dance
paymasters	paymasters
workmate	workmate
him	him
mike	mike
twenty-five	twenty-five
swells	s - well - s
cast	cast
doorstep	doorstep
reeked	reek - ed
tea	tea
care	car - e
foot-track	foot-track
puritanism	puritanism
pinkish-grey	pinkish-grey
banner	banner
misery	misery
meals	meal - s
wars	war - s
patches	patch - e - s
knell	knell
historic	historic
softness	softness
furtively	furtive - ly
thirtyone	thirtyone
promising	promis - ing
basement	basement
accepted	accept - ed
nasty	nasty
hiding	hiding
description	description
ropes	rope - s
namely	name - ly
aggressive	aggressive
roughed	rough - ed
deafeningly	deafening - ly
he	he
lungs	lung - s
pump	pump
bering	be - ring
beliefs	belief - s
disappearance	dis - appearance
eliminated	eliminat - ed
occupy	occupy
tremulous	tremulous
sickened	sicken - ed
corrections	correct - ion - s
knocking	knock - ing
greetings	greet - ing - s
lettering	letter - ing
dubleplusungood	dubleplusungood
drawer	draw - er
glasses	glass - e - s
sheltering	shelter - ing
supported	support - ed
recapture	re - captur - e
due	due
notebook	notebook
develop	develop
half-litre	half-litre
blue	b - lue
recruit	re - cruit
moment	moment
nonexistent	nonexistent
rolls	roll - s
eradicated	eradicate - d
truck	truck
aaronson	aaronson
nuclei	nuclei
delusion	delu - s - ion
scheme	scheme
crudely	crude - ly
impressed	impress - ed
evading	evading
apply	app - ly
besieged	besieged
business	business
discountenanced	discountenanced
livid	livid
toward	toward
grinding	grinding
berlin	berlin
bandaged	bandaged
centimetres	centimetre - s
channels	channels
truncheons	truncheon - s
hate	hat - e
apparatus	apparatus
shout	shout
re-arrested	re- - arrest - ed
sport	sport
atrocities	atrocit - ies
counter-revolutions	counter-revolut - ion - s
gymnastics	gymnastic - s
laundering	launder - ing
outlaws	outlaw - s
whirled	whirl - ed
overflowing	overflowing
worried	worri - ed
becomes	become - s
stampede	stamp - ed - e
roots	root - s
lassitude	lassitude
east	east
deviation	deviation
dwelling-houses	dwelling-hous - e - s
handfuls	handfuls
sprouted	s - p - rout - ed
gets	get - s
solar	s - olar
shouted	shout - ed
crumbling	crumbl - ing
freezes	freeze - s
meanings	mean - ing - s
relied	re - lie - d
briefly	brief - ly
gleaming	gleam - ing
praise	p - rais - e
programmes	programme - s
catch	c - atch
freed	f - reed
oh-o-o-o-oh	oh-o-o-o-oh
continuity	continu - ity
latent	latent
nerves	nerve - s
struggles	struggl - e - s
40	40
failed	fail - ed
hairy-eared	hairy-eared
regulation	regulat - ion
advance	advanc - e
monkey	monkey
romantic	romantic
super-states	super-state - s
escape	escap - e
perversion	pervers - ion
lower	lower
combination	combin - ation
mattresses	mattress - e - s
isolated	isolat - ed
true	true
eroticism	eroticism
inscrutability	inscrutability
over-ripe	over-ripe
beamed	b - eamed
torpid	torpid
delegates	delegates
squares	s - quare - s
prepositional	p - repositional
suffocation	suffocation
shadowy	shadowy
protector	protect - or
coverlet	coverlet
words	word - s
ladle	ladl - e
starvation	s - tarvation
inprecorr	in - precorr
notion	notion
influenced	influenc - ed
remarked	remark - ed
advancing	advanc - ing
2+2=5	2+2=5
appreciatively	appreciat - ive - ly
dark-blue	dark-blue
bought	b - ought
eastasia	eastasia
opposing	oppos - ing
half-forgotten	half- - forgotten
fright	f - right
sternly	stern - ly
spiral	spiral
bulge	bulg - e
inalterable	in - alterable
shalt	s - halt
the	t - he
holds	hold - s
horror	horror
drearily	drearily
wakefulness	wakefulness
marbled	marbled
speaking	speak - ing
unpacked	un - pack - ed
chuck	chuck
forgotten	forgotten
cheery	cheer - y
harmless	harmles - s
triumphantly	triumphant - ly
overtime	overtime
strained	s - train - ed
awkwardness	awkward - ness
functions	function - s
inhabited	inhabited
ripped	ripped
are	ar - e
scholarly	scholarl - y
bullets	bullet - s
reality-control	re - al - ity-control
handy	hand - y
preliminary	preliminary
branch	branch
respite	respite
solid-looking	s - olid-look - ing
emotion	emotion
nursing	nursing
grasp	grasp
muscles	muscles
rapidly	rapid - ly
abominably	a - bominably
comprehensive	comprehens - ive
sling	sling
counter-revolutionary	counter-revolutionar - y
hung	hung
pounds	pound - s
reducible	re - ducible
tuneful	tuneful
surprising	s - urpris - ing
up-and-down	up-and-down
absentmindedly	absentminded - ly
constructions	construction - s
excellence	excell - ence
natural	natur - al
tin	t - in
vocabularies	vocabular - ies
undesirable	un - desirable
inalienable	in - alien - able
broad	broad
mustard	mustard
hi	hi
never-mentioned	never-mentioned
whoever	whoever
defective	defect - ive
miserable	miserable
imitate	imitat - e
uncertainty	un - certainty
resurrected	re - surrect - e - d
howling	howling
else	else
dice	d - ice
striven	strive - n
worker	work - er
research	re - search
accept	accept
self-contained	self- - contain - ed
ended	end - ed
shape	shape
elbows	elbow - s
german	german
direction	direct - ion
noted	not - ed
trumpets	trumpet - s
alley	all - e - y
ninth	ninth
neatness	neatness
order	order
cock-crow	cock-crow
search	search
example	example
designed	design - ed
horseback	horseback
accomplished	accomplish - ed
ate	at - e
biased	bias - ed
statuesque	s - tatuesqu - e
length	length
rectification	rectifi - cation
osiris	osiris
rewritten	re - written
entailed	entail - ed
clicking	click - ing
interval	interval
lighted	light - ed
reconstruct	re - construct
seventy-five	seventy-five
shoulder	should - er
sums	sum - s
though	though
microphones	microphone - s
pursue	pursu - e
teledep	teledep
antefiling	ante - filing
feed	feed
prisoner	prison - er
matchwood	matchwood
bicep	bicep
claims	claim - s
sincerity	sincerity
excited	excit - ed
painted	paint - ed
chunk	c - h - unk
subjection	subject - ion
cat-o'-nine	cat-o'-nine
knot	knot
bluebell	bluebell
finished	finish - ed
incompatible	incompatible
evident	evident
august	august
imagination	imagin - ation
exploded	explode - d
demur	demur
claiming	claim - ing
musician	musician
devil	d - evil
twigs	twig - s
usage	usage
flags	flag - s
executive	execut - ive
directive	direct - ive
skimmed	skimm - ed
sandpaper	sandpaper
sake	s - ake
tickle	tickle
ill-favoured	ill-favoured
ridiculous	ridiculous
until	until
sash	sash
coldness	c - oldness
concealment	conceal - ment
delivering	deliver - ing
appear	appear
renting	rent - ing
persecuting	persecut - ing
returned	re - turn - ed
menacingly	menac - ing - ly
sordid	s - ordid
tunic	tunic
slab	slab
called	call - ed
nearly	near - ly
meagreness	meagre - ness
bored	b - ore - d
abandoned	abandon - ed
dial	dial
jones	jones
moment-to-moment	moment-to-moment
translations	translat - ion - s
fragmentary	fragment - ary
constantly	constant - ly
purple	purple
wave	wave
theoretically	theoretical - ly
conquering	conquer - ing
hereditary	hereditary
footpath	footpath
boil	boil
populous	populou - s
smallest	small - est
banquet	b - anquet
bluebells	bluebell - s
obscenity	obscen - ity
talked	talk - ed
high-heeled	high-heeled
worked	work - ed
side	side
jerks	jerk - s
rumbling	rumbl - ing
invite	invit - e
dedicated	dedicated
doubt	doubt
motor-car	motor-car
pairs	pair - s
pub	pub
news	new - s
swift	swift
odour	odour
quivering	quiver - ing
quoted	quot - ed
beetle	beetle
singlet	singlet
tedious	tedious
drastically	drastical - ly
indirectly	in - direct - ly
alcove	alcove
flimsy	flimsy
spy	s - py
mortgage	mortgage
stirred	stirr - ed
imaginings	imagin - ing - s
contrived	contrived
rose-hip	rose-hip
next	next
eclipse	eclips - e
ant	ant
eighteen-thirty	eighteen - -thirty
discredit	dis - credit
gratefully	gratefully
containing	contain - ing
doorways	doorway - s
attractive	attract - ive
accordance	accord - ance
deed	deed
chairs	c - hair - s
endlessly	endless - ly
coated	coat - ed
colchester	colchester
sub	sub
age	age
unbidden	unbidden
audible	audible
skies	skies
weakly	weak - ly
political	political
forlorn	forlorn
orders	order - s
campaign	campaign
cause	cause
gravely	grave - ly
mated	mat - ed
paraphrase	paraphrase
oblivion	oblivion
belonging	belong - ing
cardinal	cardinal
overheads	overhead - s
midsummer	midsummer
ear-splitting	ear-splitt - ing
positive	positive
shorthand	shorthand
response	respons - e
corruption	corrupt - ion
see	see
choose	choos - e
sewers	s - ewers
somewhat	somewhat
confesses	confess - e - s
stamp	stamp
emotionally	emotion - ally
involving	involv - ing
chanced	chanc - ed
stop	s - top
standards	standard - s
terrifying	terrify - ing
free	free
clumsy	c - lum - s - y
bumps	bump - s
crack	crack
fierce	fierce
lasted	last - ed
sacred	sacred
nipper	nipper
pledge	p - l - edge
kid	kid
utilitarian	utilitarian
over-sixteens	over-sixteens
'ead	'ead
price	p - rice
technicalities	technical - ities
ruffianism	ruffianism
industrial	industrial
moves	move - s
troubling	troubl - ing
washtub	washtub
opening	open - ing
pealing	peal - ing
buy	bu - y
interchangeability	interchangeability
changed	change - d
loving	l - oving
partition	partition
commanding	command - ing
accurate	accurate
underwater	underwater
dwelling-places	dwelling-places
vast	vast
possess	possess
'at	'at
individualism	individual - ism
inequality	in - equality
experienced	experience - d
strapped	s - t - rapped
doesn't	doesn't
award	award
bow	b - ow
insemination	insemination
negatived	negativ - ed
ceylon	ceylon
breeze	breeze
realize	realiz - e
falsified	falsifi - ed
crowd	crowd
aroused	aroused
firmly	firm - ly
grey	grey
squads	squad - s
dim	dim
knoll	knoll
listen	listen
climates	climate - s
abundantly	abundantly
dark-brown	dark-brown
cowered	cowered
seizure	s - eizure
stroll	stroll
absolute	absolute
baby	b - aby
let	let
look	look
frequented	frequent - ed
ceilings	ceilings
tendencies	tendenc - ies
focus	focus
atlantic	a - tlantic
elm	elm
hat	hat
unusual	un - usual
flopped	flopped
utter	utter
watched	watch - ed
fitted	fitt - ed
hypodermic	hypodermic
beyond	beyond
two-ounce	two-ounc - e
white-tiled	white-tiled
dressed	dress - ed
surrounded	surround - ed
grasped	grasp - ed
indifferently	in - different - ly
chasing	chas - ing
relaxation	relaxation
sporadically	sporadically
finger	finger
bristled	bristled
slight	s - light
nightmare	nightmare
earthenware	earthenwar - e
disengaged	disengage - d
oceania	oceania
annihilation	annihilat - ion
sale	s - ale
blew	b - lew
calm	calm
daydream	daydream
fascination	fascinat - ion
partisanship	p - artisans - hip
undetected	un - detect - ed
blurry	b - lurry
afterwards	afterwards
forests	forest - s
whiff	whiff
dace	dace
polysyllabic	polysyllabic
stopped	stopp - ed
knees	knee - s
mask	mask
commandments	command - ment - s
fatter	fatt - er
favoured	favoured
hesitation	hesitation
oppressed	oppress - ed
band	band
self-forgetfulness	self-forgetfulness
corrugated	corrugat - ed
corrupted	corrupt - ed
swallowers	swallow - er - s
privacy	privacy
expressions	express - ion - s
thumb	thumb
began	began
yet	yet
chair	c - hair
apparently	apparent - ly
raising	rais - ing
noble	noble
arrows	arrow - s
manoeuvre	manoeuvr - e
avenue	avenu - e
gabbling	gabbl - ing
synthetic	synthetic
1940	1940
combine	combin - e
confirmation	confirmation
stupidity	stupid - ity
falsification	falsifi - cation
mottled	mottled
thoughtcrime	thoughtcrime
solitude	solitude
deep-lunged	deep-lung - ed
pasture	pastur - e
handle	handle
re-educating	re- - educat - ing
intellectuals	intellectual - s
likely	like - ly
similar	similar
'ave	'ave
calf	c - alf
needless	needle - s - s
sister-in-law	sister-in-law
dress	dress
reduced	reduc - ed
elegantly	elegant - ly
's	's
cattle-track	cattle-track
never	never
physically	physical - ly
plunger	plung - er
songs	s - ong - s
adverbs	adverb - s
unimagined	un - imagin - ed
chastity	chastity
decadence	decadence
14.2.84	14.2.84
coat	coat
communicating	communicat - ing
darwin	darwin
don't	don't
freedom	freedom
frost	frost
only	only
uniformity	uniform - ity
hollow	hollow
ninety	ninety
red	red
clankclank	clankclank
speakwrites	speakwrite - s
145	145
provide	provide
constricted	con - strict - ed
clamoured	clamoured
flown	flown
collections	collect - ion - s
type	type
dominated	dominat - ed
time	time
deserved	deserv - ed
snow-white	snow-white
abounds	abound - s
nineteen	nineteen
member	member
lamps	lamp - s
older	old - er
strip	s - trip
austere	austere
blond-headed	blond-headed
trousers	trouser - s
benevolent	benevolent
medicine	medicin - e
disappeared	dis - appear - ed
flattened	flatten - ed
stallkeepers	stallkeeper - s
oiled	oil - ed
bodies	bodie - s
delay	delay
far	far
sandyhaired	sandyhair - ed
gauge	gauge
struggling	struggl - ing
telescoped	telescop - ed
verifying	verify - ing
listening	listen - ing
brief	brief
heads	head - s
sold	s - old
defences	defences
peculiar	peculiar
effigies	effigies
nearer	near - er
've	've
cabbage	cabbage
doing	doing
departments	department - s
oceanic	oceanic
year	year
3,000	3,000
invariably	invariabl - y
leafless	leafle - s - s
were	were
nobby	nobby
off	off
purity	purity
centres	centre - s
bulk	bulk
blood-ties	blood-ties
fled	fled
pointless	point - less
ruined	ruin - ed
infrequently	in - frequent - ly
paris	pari - s
draw	draw
children	children
refugees	refugee - s
well-defined	w - ell-defined
breathed	breath - ed
concern	concern
beard	beard
sufficient	sufficient
teen	t - een
privileges	privilege - s
trick	trick
unmistakably	unmistakabl - y
dripping	d - ripping
speeded	speed - ed
quarters	quart - er - s
economic	economic
beat	b - eat
weight	weight
renamed	re - name - d
sallower	s - allow - er
tinier	tinier
curve	curv - e
return	re - turn
remorselessly	remorseless - ly
definition	definition
pleasanter	pleasant - er
thickly	thick - ly
treacheries	treacher - ies
winning	winn - ing
lift-shaft	lift-shaft
reappearance	re - appearance
side-street	side-street
discontents	dis - content - s
myriad	myriad
women	women
dully	dull - y
counting	count - ing
multiplied	multiplie - d
bulkiness	b - ulkiness
remainder	remain - d - er
pot	pot
devices	device - s
closing	clos - ing
staring	star - ing
retaining	re - tain - ing
lengthways	lengthway - s
unwritten	un - written
bourgeoisie	bourgeoisie
present-day	present-day
racked	racked
alternately	alternately
extended	extend - ed
faculty	faculty
happiness	happiness
doors	door - s
hers	her - s
carrot	carrot
concealing	conceal - ing
as	as
sees	see - s
tested	test - ed
gyrating	gyrat - ing
traitors	traitor - s
demanded	demand - ed
rash	rash
motives	motive - s
handwriting	handwrit - ing
regimented	regiment - ed
resettled	resettl - ed
rapings	raping - s
nodding	nodd - ing
soles	sole - s
conspirators	conspirator - s
collectively	collect - ive - ly
faintness	faint - ness
quarts	quart - s
enveloping	envelop - ing
notes	note - s
indoor	in - door
heart	heart
animal	animal
anonymous	anonymous
organism	organism
defended	defend - ed
inflicted	inflict - ed
projecting	project - ing
repairing	re - pair - ing
stability	s - t - ability
worries	worri - e - s
parted	part - ed
amateur	amateur
fertile	fertil - e
violently	violent - ly
capitals	capital - s
steadily	steadily
deliver	deliver
told	t - old
lands	land - s
stacked	s - tack - ed
invented	invent - ed
affected	affect - ed
average	average
enemy	enemy
est	est
slinging	sling - ing
treading	t - read - ing
crooked	c - rook - ed
rags	rag - s
spinning	spin - n - ing
behind	behind
about	about
alone	alone
bedroom	bedroom
cylindrical	cylindrical
armada	armada
dared	dare - d
outrages	outrag - e - s
making	m - aking
admonished	admonish - ed
swirled	swirl - ed
admit	admit
novelettes	novelette - s
dipped	dipp - ed
block	b - lock
jam	jam
oily-tasting	oily-tasting
friend	friend
stupor	stupor
syphilis	syphilis
coverless	cover - less
welcome	welcome
hiding-place	hiding-place
artist	artist
united	unit - ed
fewer	few - er
welled	well - ed
wrapped	w - rapped
sneeze	sneeze
nineteen-thirty	nineteen - -thirty
dozing	dozing
cool	c - ool
lenses	lenses
intensity	in - tens - ity
eastasian	eastasian
miscellaneous	miscellaneou - s
served	serve - d
so-and-so	so-and-so
conquered	conquer - e - d
compulsion	compulsion
appeals	appeal - s
blanket	blanket
colder	c - old - er
springy	spring - y
entirely	entire - ly
prison	prison
consigned	con - sign - ed
preached	p - reach - ed
lectures	lecture - s
stalls	s - t - all - s
persevered	persever - ed
cease	ceas - e
fertilized	fertilized
funny	funny
regularly	regular - ly
stricken	s - trick - en
illuminate	illuminate
snatches	snatch - e - s
artsem	artsem
assailed	assailed
main	main
rhine	rhine
increasing	in - creas - ing
criticize	criticize
game	game
perfectly	perfect - ly
enclosing	enclos - ing
secure	secur - e
orderly	order - ly
seizes	seiz - e - s
audience	audienc - e
story	stor - y
loyalties	loyaltie - s
equatorial	equatorial
mannerism	manner - ism
shown	show - n
device	device
legend	legend
change	change
hand-spans	hand-span - s
gloating	gloating
pouched	pouch - ed
second	second
poverty	poverty
threats	threat - s
recognizing	recogniz - ing
corn	c - orn
primal	p - rim - al
grimacing	grimacing
aware	aware
pools	p - ool - s
mood	mood
reinscribed	re - inscribed
unsinkable	unsinkable
reminiscently	reminiscently
accumulated	accumulat - ed
use	us - e
vapid	vapid
comrades	comrade - s
gold	gold
counter-revolutionaries	counter-revolutionar - ies
hunting-down	hunting-down
mystique	mystique
dodges	dodge - s
application	applic - ation
agreement	agree - ment
stout	s - t - out
suspicion	suspic - ion
passengers	passengers
mouth	mouth
reputation	reputation
extend	extend
briefcase	briefcas - e
fortresses	fortress - e - s
persists	persist - s
surely	sure - ly
rubbed	rubb - ed
irresponsible	ir - responsible
cruelty	cruel - t - y
perched	perched
painters	paint - er - s
producers	produc - er - s
inexhaustibly	inexhaustibl - y
reclaim	re - claim
sprinkle	s - p - rinkle
issue	issu - e
shower	show - er
should	should
nazi	nazi
embracing	embrac - ing
muscular	muscular
regularity	regular - ity
drown	drown
government	govern - ment
prole	prole
gummed-up	gummed-up
staffs	staff - s
bud	bud
district	di - strict
deportations	deportation - s
black	b - lack
discarded	discarded
spat	s - p - at
enumerate	enumerate
danger	danger
barely	bare - ly
despairing	despair - ing
base	base
frankly	frank - ly
generalized	general - ized
maintain	maintain
meditatively	meditat - ive - ly
s	s
stocks	stock - s
stripped	s - t - ripped
tasted	taste - d
astonished	astonish - ed
hours	hour - s
excluded	exclud - ed
hurry	hurry
number	number
lark	l - ark
cock	c - ock
trickery	trickery
blunt	blunt
bells	bell - s
circle	circle
fat	f - at
anthologies	anthologie - s
glance	glanc - e
monopoly	monopo - ly
simian	simian
stock	stock
underemployed	under - employed
preference	p - reference
soap	s - oap
fellow-tenant	fellow-tenant
underlying	under - ly - ing
digressions	digression - s
decades	decade - s
oranges	oranges
hostel	hostel
processes	process - e - s
self-deception	self- - deception
naggingly	nagging - ly
dictatorship	dictatorship
required	requir - ed
flinging	fling - ing
paraffin	p - araffin
single-mindedness	single-mindedness
unwillingly	un - willing - ly
gradual	gradual
recollect	re - collect
boulders	b - oulders
gritty	gritty
tube	tube
securely	secur - e - ly
enjoyed	enjoy - ed
racket	racket
products	product - s
commit	commit
testimony	testimony
letter	letter
coloured	colour - ed
aint	aint
grasping	grasp - ing
futile	futile
nameless	namele - s - s
chilly	chill - y
joint	joint
wispy	wisp - y
flying	f - lying
boo	boo
general	general
hungrily	hungrily
twenty	t - w - ent - y
wrecking	wreck - ing
gravy	grav - y
mingled	m - ingl - ed
philosophical	philosoph - ical
believing	believ - ing
heel	heel
collector	collect - or
attracted	attract - ed
boos	boo - s
judgement	judgement
commemorating	commemorat - ing
landing	land - ing
intrigue	intrigue
salvation	salvat - ion
unfreedom	un - freedom
inflamed	in - flamed
milk	milk
boy	boy
seditious	s - editious
tie	t - ie
throats	throat - s
welded	weld - ed
scraps	scrap - s
harmonize	harmonize
twig	twig
foodstuffs	foodstuffs
declared	declared
throbbing	throbb - ing
snuffboxes	snuffbox - e - s
roar	roar
hike	hike
jealously	jealously
nagging	nagging
compared	compar - ed
storm	storm
flank	flank
climate	climate
incriminating	in - criminat - ing
dreams	dream - s
spring	spring
scribbled	scribbl - e - d
lemon	lemon
babies	babies
cared	car - ed
mathematicians	mathematician - s
myself	myself
shaved	s - have - d
loses	los - e - s
absorption	absorpt - ion
belongs	belong - s
flagstaffs	flagstaffs
fourpence	fourpenc - e
corpses	corpse - s
upper	up - per
specious	speci - ous
backslider	backslider
commented	comment - ed
letters	letter - s
mirror	mirror
reassure	reassur - e
servants	servant - s
telling	telling
members	member - s
warriors	warrior - s
wrenching	wrench - ing
conformity	con - form - ity
approached	approach - ed
sand-like	sand-like
minuteness	minute - ness
gases	gases
along	a - long
indicating	indicat - ing
innumerable	in - numerable
masters	master - s
drive	driv - e
oughter	ought - er
1973	1973
3.12.83	3.12.83
papers	paper - s
has	ha - s
shrivelled	shrivelled
speech	speech
straight-featured	straight-featured
dirty	dirt - y
distort	distort
looking	look - ing
glass	glass
restricting	re - strict - ing
theatre	theatre
overtones	overtones
whimpered	whimper - ed
early	ear - ly
lift	lift
scribbles	scribbl - e - s
damned	damn - ed
disliked	dis - like - d
tightly	tight - ly
changes	change - s
retained	re - tain - ed
rebellion	rebellion
gives	give - s
taken	take - n
levels	level - s
saturday	saturday
sausages	sausages
wits	w - it - s
discover	dis - cover
home	h - ome
dated	date - d
architecture	architecture
silver	s - ilver
won	w - on
chocolate-ration	chocolate-ration
induce	induce
managed	manag - ed
oozing	oozing
peered	peer - ed
reason	reason
riot	riot
tolerated	tolerate - d
bring	b - ring
speak	speak
documents	document - s
swim	s - wim
mindless	mindless
gulp	gulp
luminous	luminous
celebrate	celebrate
boredom	boredom
yellowish	yellow - ish
mention	mention
inefficient	in - efficient
satisfied	satisfi - ed
quick-witted	quick-witted
verify	verify
statement	statement
flesh	flesh
comforted	comfort - ed
daughter	daughter
paler	p - aler
wet	we - t
frock	f - rock
aggressively	aggressive - ly
chamber	chamb - er
packed	pack - ed
identified	identifi - ed
chill	chill
slid	slid
adored	adore - d
paper	paper
creature	creature
terrace	terrace
looks	look - s
tearing	tearing
cloth	cloth
conduct	conduct
exists	exist - s
belief	belief
geography	geography
holding	hold - ing
omnipotent	omnipotent
darkened	darken - ed
cloves	c - love - s
tormenting	torment - ing
writers	writer - s
ashamed	a - sham - ed
association	association
baskets	basket - s
enthusiastically	enthusiastic - ally
gathering	gather - ing
explored	explore - d
gravitated	gravitat - ed
boxing-gloves	boxing-gloves
rumour	rumour
our	our
kaleidoscopes	kaleidoscope - s
bald	bald
contempt	con - tempt
eat	eat
gave	gave
systematic	systematic
arithmetical	arithmetic - al
dear	d - ear
extremity	extremity
wise	wise
corner	corner
made	made
attendances	attend - ance - s
jagged	jagged
rat	rat
starve	starv - e
plus	plus
scrubbed	scrubb - ed
beside	be - side
shall	s - h - all
lacked	lack - ed
dreamt	dream - t
proprietor	proprietor
uncontrollable	un - controllable
wasted	waste - d
mane	man - e
greyish	grey - ish
apart	a - part
black-uniformed	black-uniformed
crook	c - rook
litres	litre - s
differentiated	differentiat - ed
fifty	fifty
thirteen	thirteen
conflicted	conflict - ed
intermittently	intermittent - ly
overheard	overhear - d
loosened	loos - en - ed
system	s - ystem
bumped	bump - ed
memories	memor - ies
hunk	h - unk
intercommunication	inter - communicat - ion
cross	cross
duckspeak	duckspeak
height	h - eight
word-formation	word-formation
current	current
spies	s - p - ie - s
throwing	throw - ing
loose	loos - e
railing	rail - ing
telescreen	telescreen
spotting	s - pott - ing
entrails	entrails
partly	part - ly
erecting	erect - ing
practical	practic - al
sceptical	sceptical
irrespective	ir - re - spect - ive
litter	litter
contradict	contradict
frontispiece	frontispiece
picking	pick - ing
premonitory	premonitory
shame	sham - e
invisibility	invisibility
happier	happier
fifteen-thirty	fifteen-thirty
treadmill	t - readmill
french	french
running	running
execution	execut - ion
shop-front	s - hop-front
named	name - d
privileged	privilege - d
wondered	wonder - ed
ladders	ladder - s
shoulders	should - er - s
slave	slave
beast-like	beast-lik - e
administrator	administrator
eyes	eye - s
voluptuous	voluptuous
instalments	instalment - s
still	still
indoors	in - door - s
bat	b - at
lit	lit
carelessly	careless - ly
sister	sister
mended	mend - ed
despicable	despicable
't	't
stake	s - take
intervals	interval - s
indians	indian - s
cautious	cautious
attempted	attempt - ed
flights	f - light - s
patch	patch
closed	clos - ed
lie	lie
leaden	lead - en
privilege	privilege
demolish	demolish
impregnable	impregnable
run	r - un
mournful	mournful
sing	sing
2713	2713
mammoths	mammoths
reconciling	reconcil - ing
crash	c - rash
tortured	torture - d
amplifiers	a - mplifiers
doomed	doom - ed
writing	writing
slightly	s - light - ly
maddening	madden - ing
facing	f - acing
colonies	colonies
waddled	waddl - ed
relinquishing	re - linquishing
endure	endur - e
pediment	pediment
bench	bench
reasserted	re - assert - ed
democracy	democracy
move	move
tallish	tallish
tyranny	tyranny
active	active
insulted	insult - ed
turning	turn - ing
counterpane	counterpane
dirty-looking	dirty-look - ing
reserved	reserved
building	build - ing
apologetic	apologetic
gone	gone
reduce	reduce
indignantly	indignant - ly
possibilities	possibilit - ies
amused	amuse - d
gin-drinking	gin-drink - ing
goodwise	goodwise
dislocation	dislocat - ion
sheer	sheer
nice	nice
evidence	evidence
arrange	arrange
bulletins	bulletin - s
despotism	despotism
strictly	strict - ly
pile	pile
deadly	deadly
menacing	menac - ing
remote	remote
flicked	f - licked
flow	flow
route	rout - e
quarrels	quarrel - s
sheet	sheet
struggled	struggl - ed
impenetrable	impenetrabl - e
musty	musty
pardoned	pardon - ed
corked	cork - e - d
precautionary	precautionary
respectively	re - spect - ive - ly
foreigners	foreign - er - s
antiquity	antiquity
patched-up	patched-up
currency	currenc - y
abashed	a - bashed
concessions	concession - s
meant	mean - t
suppression	suppress - ion
hot	hot
friendliness	friendlines - s
clement	clement
pulled	pull - ed
filing	filing
isolation	isolat - ion
nineteenth	nineteen - th
refrigerator	refrigerator
attacked	attack - ed
tasteless	taste - less
machine	machine
rub	rub
seemingly	seem - ing - ly
slip	s - lip
twenty-four-hour-a-day	twenty-four-hour-a-da - y
overturn	overturn
worth	worth
sentiment	sentiment
shut	shut
ragged	r - agged
bullying	bullying
estimate	estimate
hong	h - ong
objective	object - ive
doubtful	doubt - ful
send	s - end
painting	paint - ing
distilled	distilled
arguing	argu - ing
accident	accident
coincidence	coincid - ence
entitled	entitl - ed
quicken	quick - en
undoubtedly	un - doubt - ed - ly
feet	feet
intend	intend
explosions	explosion - s
function	function
informers	in - former - s
planted	plan - t - ed
suspended	suspended
endured	endur - ed
tibet	tibet
insurrection	in - surrect - ion
deceive	deceiv - e
wool	w - ool
efficiency	efficiency
stiffen	stiffen
pink	p - ink
up-to-dateness	up-to-datenes - s
asleep	a - sleep
begotten	begotten
identifying	identifying
jest	jest
sadness	s - adness
cling	cling
acid	acid
devotion	devot - ion
ed	ed
fallen	fall - en
poor	poor
suicidal	s - uicid - al
stared	star - ed
wrappings	wrapping - s
holes	hole - s
sweltering	sweltering
fortunes	fortunes
follows	follow - s
queues	queue - s
collect	collect
terms	term - s
parades	parad - e - s
unchangeable	un - change - able
write	write
consider	consider
hottest	hottest
attending	attend - ing
bandits	bandit - s
worse	wors - e
stepney	stepney
picture	picture
personally	person - ally
pouchy	pouch - y
old-fashioned	old-fashioned
guise	guis - e
organizers	organiz - er - s
darted	dart - ed
happened	happen - ed
cosmetics	cosmetics
persistence	persist - ence
procured	procur - ed
murderous	murder - ous
flight	f - light
deeper	deep - er
darts	dart - s
explains	explain - s
refugee	refugee
blackwhite	b - lackwhite
flower	flower
ideology	ideology
inner	inn - er
animated	animat - ed
lever	lever
agonizingly	agonizing - ly
repeat	repeat
immunized	immunized
thicker	thick - er
spare	spare
step	s - tep
pig-iron	pig-iron
up	up
steamer	s - team - er
intention	in - tention
interpreted	interpret - ed
reconciliation	reconciliation
anybody	anybody
surprise	s - urpris - e
tour_de_force	tour_de_forc - e
bushy	bushy
blown	b - low - n
extent	extent
pace	pace
timber	timber
goodsex	goodsex
convulsive	convuls - ive
filthy	filth - y
manner	manner
balls	b - all - s
activity	activit - y
competed	compet - ed
continuous	c - ontinuous
drawn	draw - n
dinginess	dingines - s
dimpled	dimpl - ed
hemisphere	hemispher - e
discretion	discretion
granite	granite
fault	fault
willow	willow
blowlamp	blowlamp
cultivated	cultivat - ed
cheer	cheer
previous	previous
uncle	uncle
latter	latter
secondly	second - ly
dense	dense
preponderance	preponderance
unsolved	un - solved
fund	fund
praising	p - rais - ing
keying	keying
arrive	arriv - e
make-up	make-up
hanging	hang - ing
perceptibly	perceptibl - y
machinery	machine - r - y
digging	digg - ing
foretaste	fore - taste
fragile	fragil - e
repeated	repeat - ed
reappeared	re - appear - ed
rhythmical	rhythm - ical
roused	ro - used
tending	t - ending
important	important
rate	rat - e
with	with
tolerates	tolerate - s
discussion	discuss - ion
redhaired	re - d - hair - ed
buttons	buttons
perished	perish - ed
emphasized	emphas - ized
heretic	heretic
abstractedly	abstract - ed - ly
crawling	crawl - ing
articles	article - s
maze	maz - e
shells	s - hell - s
diary	diary
insatiably	insatiably
boundaries	boundaries
warned	warn - ed
works	work - s
vomited	vomit - ed
categories	categories
brutal	brut - al
philosophies	philosoph - ies
roars	roar - s
riding	riding
conditions	condition - s
sagged	s - agged
sun	s - un
neutralized	neutralize - d
cancelled	cancelled
crocuses	crocuse - s
formally	form - al - ly
discoloured	dis - colour - ed
nicknamed	nickname - d
rooftops	rooftops
unflinchingly	un - flinch - ing - ly
examined	examin - ed
detect	detect
guarded	guard - ed
bootlaces	bootlaces
gentler	gentler
surly	surly
ampoule	ampoule
teams	team - s
silkiness	silkiness
pattered	patt - er - ed
gains	gain - s
faded	fad - ed
afraid	afraid
thee	thee
winners	winn - er - s
smattering	s - matter - ing
commercial	commercial
shrunk	shrunk
rocks	rock - s
desk	desk
infallibility	infallibility
offices	offic - e - s
capitalist	capitalist
goes	go - e - s
york	york
education	educat - ion
truth-producing	t - ruth-produc - ing
bearing	bear - ing
pads	pad - s
tired	tir - ed
houses	house - s
fold	fold
suspected	suspect - ed
eighteen	eighteen
subsided	subsid - ed
paused	paus - ed
hay	hay
doubts	doubt - s
fear	fear
archaic	archaic
capture	captur - e
caste	cast - e
drilling	drill - ing
coveted	coveted
irritation	irritat - ion
machines	machine - s
image	im - age
ocean	ocean
surfaces	surface - s
earnest	earnest
failures	failure - s
pegs	pegs
centary	cent - ary
wherever	wherever
choice	choice
springiness	s - pringiness
actuality	actual - ity
swallowed	swallow - ed
pronouns	pro - noun - s
utterly	utter - ly
unconvincing	un - convinc - ing
totalitarians	totalitarian - s
reconciled	reconcil - ed
amid	amid
mouthfuls	mouthful - s
rosebud	rosebud
pull	pull
slipped	s - lipped
owns	own - s
waxed-faced	waxed-faced
eh	eh
cruel	cruel
conspiracy	conspiracy
suitable	suitable
indispensable	indispensabl - e
memorable	memor - able
otherwise	other - wise
suffer	s - uffer
trusting	trust - ing
enrolling	en - roll - ing
contradictions	contradict - ion - s
freckled	freckle - d
minded	mind - ed
endowed	endowed
shrivel	shrivel
uniforms	uniform - s
posts	post - s
exact	exact
impose	impos - e
common	common
vitriol	vitriol
troop-leader	troop-leader
offending	offend - ing
separated	separat - ed
shades	shade - s
business-like	business - -like
football	football
coats	coat - s
devoted	devot - ed
recognition	recognition
miniluv	miniluv
hotter	hot - t - er
ingrained	in - grain - ed
shake	s - hake
handing-over	handing-over
fuel	fuel
subtle	subtl - e
gain	gain
prostrated	prostrated
left	left
meagre	meagre
circulated	circulat - ed
sign	sign
mouths	m - outh - s
glamour	glamour
advanced	advanc - ed
lank	lank
withstand	withstand
candlestick	candlestick
print	print
twenty-six	t - wenty-six
eight-thirty	eight-thirty
relatives	relative - s
sourish	s - ourish
whines	whines
professional	professional
impudently	impudent - ly
hoped	hop - ed
rabbits	rabbit - s
ready	read - y
inherently	inherent - ly
sodden	s - odd - en
trial	trial
blubbered	blubber - ed
begin	begin
lamp	lamp
manners	manner - s
pillars	pillar - s
prostitute	prostitute
mixture	mixture
historical	historic - al
paxful	paxful
work-hardened	work-hardened
vainly	vain - ly
terror	t - error
collective	collect - ive
sweep	s - weep
haste	haste
heat	heat
wooden-seated	wooden-seated
does	doe - s
careful	careful
coins	coin - s
survival	surviv - al
kisses	kiss - e - s
luxury	luxury
faith	faith
usual	usual
attempts	attempt - s
growth	grow - th
television	television
crashed	c - rash - ed
exercise-books	exercise-book - s
severe	s - ever - e
unlike	un - like
slow	s - low
apple	apple
twisting	twist - ing
areas	area - s
promiscuity	p - romiscuity
wishing	wish - ing
confusion	confus - ion
beastly	b - east - ly
after	after
colossus	colossus
event	event
processions	process - ion - s
sour-sweet	s - our-sweet
ffcc	ffcc
expensive	expensive
months	month - s
slide	slid - e
crackle	crackle
figured	figure - d
diffusing	diffus - ing
froglike	froglike
distant	distant
predictions	predict - ion - s
issuing	issu - ing
however	however
just	just
manchuria	manchuria
pannikin	pannikin
five-cent	five-cent
prosaically	prosaically
taught	t - aught
raspingly	rasp - ing - ly
deflated	deflated
adult	adult
fascinated	fascinat - ed
stank	s - tank
ministries	ministries
errors	error - s
regrouped	re - group - e - d
relish	relish
wrist	wrist
eavesdropping	eavesdropp - ing
lead	lead
dumpy	dump - y
limbs	limb - s
against	against
pinchbeck	pinchbeck
twenty-first	twenty-first
whitened	whitene - d
whimpering	whimper - ing
lies	lie - s
articulate	articulate
decoration	decorat - ion
peace	peace
meat	m - eat
nebulous	nebulous
sinking	s - in - king
bundled	bundle - d
portion	portion
seen	see - n
uncorking	un - cork - ing
working	work - ing
underestimated	under - estimate - d
grime	grim - e
scientific	scientific
tablet	tablet
curved	curv - ed
song	s - ong
disbelieve	dis - believ - e
hisses	hiss - e - s
antonyms	antonyms
breast	breast
cobbled	cobbl - ed
lapse	lap - s - e
porch	porch
scrubbing	scrubb - ing
tall	t - all
sham	sham
1920	1920
stamped	stamp - ed
strait	strait
teeth	teeth
loudly	loud - ly
unused	un - used
controllable	controllable
aristocrats	aristocrats
mythology	mythology
copper	copper
preoccupied	preoccupied
confessions	confess - ion - s
saint	s - aint
followed	follow - ed
anticipation	anticip - ation
falsehood	false - hood
syllable	syllable
confer	confer
tic	tic
minipeaceful	mini - peaceful
hats	hat - s
senses	sense - s
hoisted	h - oist - ed
trampled	trampl - ed
happens	happen - s
answer	answer
criminality	criminal - ity
bar-room	bar-room
furthest	furth - est
determined	determin - ed
discipline	discipline
permitted	permit - t - ed
pyramidal	pyramid - al
sorrowfully	sorrow - ful - ly
dreary	dreary
swollen	s - wollen
habits	habit - s
antibodies	antibodies
flashed	flash - ed
competent	competent
raise	rais - e
barrel	barrel
occasionally	occasional - ly
die	die
sighed	sigh - ed
italics	italics
raw	raw
refused	refus - ed
argued	argu - ed
cloud	cloud
dialled	dialled
unanswerable	un - answer - able
restore	re - stor - e
panegyric	panegyric
slaves	slave - s
propped	propped
grossly	grossly
alike	a - like
sell	s - ell
indifferent	in - different
assemble	assembl - e
room	room
under	under
moist	m - oist
misleading	mis - lead - ing
soup	s - oup
norman	norman
handing	hand - ing
other	other
british	british
monologue	monologue
cunning	cunning
team	team
alley-ways	alley-way - s
pneumatic	pneumatic
contradictory	contradict - or - y
journey	journey
basket	basket
service	servic - e
eternal	etern - al
sweeping	s - weep - ing
codeword	codeword
giving	giving
metaphysics	metaphysic - s
nominate	nominate
she	s - he
ten	t - en
febrile	f - ebrile
item	item
animals	animal - s
symbolize	symbol - ize
calves	calves
hostile	hostile
greatest	great - est
denounced	denounc - ed
halfburying	half - burying
clear	clear
drug-peddlers	drug-peddlers
over-production	over-production
inadequate	in - adequate
fattish	fatt - ish
pale	p - ale
breadcrust	breadcrust
shorter	shorter
southern	southern
confinement	confinement
definitions	definition - s
inarticulate	in - articulate
roughened	rough - en - ed
stated	stated
studios	studios
telescreens	telescreen - s
one-oh-one	one-oh-one
turn	turn
world-within-a-world	world-within-a-world
delicately	delicate - ly
allowing	allow - ing
pretentious	pretentious
quart	quart
gorgeous	gorgeous
added	add - ed
tongue	tongue
plate	p - late
will	w - ill
van	van
lemons	lemon - s
interests	interest - s
delirium	delirium
stratified	s - t - ratified
separate	separat - e
flaps	flap - s
firmness	firmne - s - s
blaring	bla - ring
blowing	blow - ing
contortionist	c - ontortionist
translated	translat - ed
spine	spin - e
stress	s - tre - s - s
baking	b - aking
physicist	physicist
believer	believ - er
possession	possession
speculations	speculations
burrow	b - urrow
emblem	emblem
goodness	goodnes - s
unvarying	unvary - ing
lipstick	lipstick
cauterized	cauterized
whiskers	whisker - s
reduction	reduc - t - ion
teacher	teach - er
erected	erect - ed
identity	identity
b-b	b-b
insufficient	in - sufficient
melancholy	melancholy
eyed	eye - d
verb	verb
naturally	naturally
sobering	sobering
asia	asia
foreseen	foresee - n
heartland	heartland
rivals	rival - s
bumstead	bumstead
ensure	en - sure
limb	limb
blackmoustachio'd	blackmoustachio'd
touching-up	t - ouching-up
)	)
reversible	reversible
wastage	wastage
useful	useful
recall	re - call
squatting	squatt - ing
capped	c - app - ed
instantly	instant - ly
intently	intent - ly
islands	island - s
embarrassing	embarrass - ing
consumed	consum - ed
worthless	worth - less
prodigies	prodigies
silly	s - illy
badly	bad - ly
king	king
lately	late - ly
flared	flar - ed
invisible	in - visible
definitively	definitive - ly
kicked	kick - ed
said	said
lose	los - e
twenty-one	t - wenty-one
starting	start - ing
weep	weep
barren	barren
plumped	p - lump - ed
mutability	mutabil - ity
happening	happen - ing
instinctive	instinct - ive
transport	transport
mean	mean
characteristics	characteristic - s
half-aware	half-aware
least	l - east
fathoms	fathom - s
heretics	heretic - s
legs	leg - s
oh	oh
pushing	push - ing
braying	bray - ing
threadbare	threadbare
vilifies	vilifies
youth	youth
mat	mat
breaking	break - ing
seeming	seem - ing
stretched	stretch - ed
chanting	chant - ing
lip-service	lip-service
mr.	mr.
nineteen-twenty	nineteen - -twenty
document	document
slanted	slant - ed
stamps	stamp - s
suffering	s - uffer - ing
continuation	continu - ation
infant	infant
lull	lull
land-mass	land-ma - s - s
reference	reference
devoured	devour - ed
scraped	scrap - ed
slate	s - late
smallish	small - ish
sustained	sustain - ed
tore	t - ore
ascribed	ascribed
dismembered	dis - member - ed
english-speaker	english-speaker
intimacy	intimacy
contained	contain - ed
listened	listen - ed
blankness	blank - ness
inspected	in - spect - ed
repositories	repositories
inscription	inscription
intensely	intense - ly
musicians	musician - s
penknives	penknives
enveloped	envelop - ed
black-market	black-market
half-pleasant	half- - pleasant
queue	queue
beauty	beauty
deceit	deceit
referred	referr - ed
unnecessary	un - necessary
populations	population - s
one-time	one-tim - e
method	method
cork	cork
amulets	amulets
rebelliousness	rebellious - ness
rhythm	rhythm
stretching	stretch - ing
threaded	thread - ed
built	built
handled	handle - d
hoardings	hoard - ing - s
shouldn't	s - h - ouldn't
trophy	trophy
ill-defined	ill-defined
lightning	light - n - ing
daydreaming	daydream - ing
distasteful	dis - taste - ful
emptiest	empti - est
babbling	babbl - ing
printed	print - ed
straps	s - traps
vision	vision
pulse	pulse
shallower	shallow - er
messenger	messenger
intricate	intricate
thousands	thousand - s
secondary	second - ary
water	water
suspect	suspect
indian	indian
afterthought	after - thought
ranging	rang - ing
eyeless	eyeless
jus_primae_noctis	jus_primae_nocti - s
regrouping	re - group - ing
sanction	sanction
chocolate	chocolate
realized	realiz - ed
bunch	b - unch
leant	lean - t
rod	rod
half-darkness	half- - darkness
psychologically	psychologically
unimportant	un - important
tray	tray
red-hot	red-hot
counter-attack	counter-attack
forced-labour	forced-labour
buttocks	buttock - s
school	school
trace	trace
mid-day	mid-day
intended	intend - ed
proclamations	proclamation - s
blazed	blaz - ed
copiously	copiously
fruity	fruit - y
inferior	inferior
oftener	often - er
pronounceable	pronounce - able
crowds	crowd - s
crude	crude
starts	start - s
spontaneous	spontaneous
world-view	world-view
bus	bu - s
clambering	clambering
unconquerable	un - conquer - able
'ats	'at - s
safely	safe - ly
friendship	friendship
sense	sense
alter	alter
task	t - ask
bold	b - old
absence	a - bsence
cleared	clear - ed
awake	a - w - ake
flaked	flake - d
lined	line - d
pudgy	pudgy
variations	variation - s
more	m - ore
daydreams	daydream - s
parenthetically	parenthetic - ally
conversation	conversation
assembly	assembl - y
empty	empty
go	go
'ealth	'eal - th
execrate	execrate
arranged	arrange - d
stand	stand
silence	silenc - e
stinking	s - tinking
theories	theor - ies
existing	exist - ing
turned	turn - ed
chequered	c - hequered
innocent	innocent
labours	labour - s
thieves	thieves
simple	simpl - e
manuals	manual - s
eyeing	eyeing
meself	m - eself
glory	glory
carnivorous	carnivorou - s
composite	composite
temporary	tempor - ary
corking	cork - ing
institutions	institution - s
printingshops	printingshops
brainy	b - rain - y
resembled	re - semble - d
repeating	repeat - ing
obvious	obvious
hoarding	hoard - ing
pitying	pity - ing
water-closets	water-closets
droning	droning
ideals	ideal - s
occasional	occasion - al
authority	author - ity
sentimental	sentiment - al
bent	b - ent
examining	examin - ing
tales	tale - s
decisive	decis - ive
happenings	happen - ing - s
further	furth - er
uneasy	un - easy
abandon	abandon
where	w - here
debate	debat - e
acquaintance	acquaintanc - e
obediently	obediently
conceal	conceal
killed	kill - ed
once	once
letting	letting
flat	flat
unappeasable	unappeasable
another	a - n - other
rainwater	rainwater
positions	position - s
sloping	slop - ing
unbearably	unbearably
germs	germs
sterner	stern - er
intimidating	in - timidat - ing
gagging	gagg - ing
goodthinker	goodthink - er
bottle	bottl - e
inventing	invent - ing
arm	arm
probably	probab - ly
reissued	re - issu - ed
western	w - estern
harm	h - arm
bell	bell
persistent	persistent
cylinders	cylinder - s
archipelago	archipelago
unsatisfactory	un - satisfactory
servitude	servitud - e
wish	wish
resurrection	re - surrect - ion
war-criminals	war-criminals
obviously	obvious - ly
whichever	whichever
murder	murder
...	...
cherish	cherish
dozen	dozen
partners	partners
blond-haired	blond-haired
roasting	r - oast - ing
leapt	leap - t
celibate	celibate
cavernous	cavernous
objectivity	objectivity
indestructible	indestructible
adulterers	adulter - er - s
admire	admire
obliged	oblig - ed
resolve	re - solve
roared	roar - ed
lady	lady
ravages	ravage - s
singled	s - ingl - ed
youthfulness	youthful - ness
stifling	stifling
dock	dock
helplessly	helpless - ly
love-affair	love-affair
strenuousness	strenuousness
attitude	attitude
brotherhood	brother - hood
distinguish	distinguish
fatal	fatal
underwent	un - derwent
shelter	shelter
pursuing	pursu - ing
weighted	weight - ed
declining	declin - ing
shots	s - hot - s
inclined	inclin - ed
accurately	accurate - ly
booziness	boozine - s - s
compound	compound
humanity	humanity
humble	humbl - e
thirty	t - hirt - y
pronunciation	pronunciation
huge	huge
area	area
prefer	p - re - fer
ring	ring
specialists	specialist - s
looked	look - ed
glimpses	glimpse - s
swirls	swirl - s
glimpse	glimpse
labour	labour
encourage	encourag - e
secretively	secret - ive - ly
relevant	relevant
path	path
purges	purge - s
fireplace	fireplace
shallow	shallow
refines	re - fine - s
climax	c - limax
property	proper - t - y
cap	cap
ramifications	ramification - s
streaks	streak - s
argentina	argentina
want	want
disputed	disputed
waiter	wait - er
exhausted	exhaust - ed
died	die - d
attack	attack
overproduction	over - product - ion
smelt	s - melt
2,000	2,000
performance	performance
anodyne	anodyne
fanatic	fanatic
frenzies	frenzies
haunting	haunt - ing
lifted	lift - ed
reported	report - ed
tickets	tickets
duckspeaker	duckspeak - er
expect	expect
communal	commun - al
harsh	harsh
mutilated	mutilat - ed
prostitutes	prostitute - s
sharply	sharp - ly
nowhere	nowhere
country	country
cell	c - ell
dominant	dominant
prettiness	pretti - ness
knife	knife
contain	contain
contacts	contact - s
countless	count - less
approximately	approximately
apologetically	apologetic - ally
beating	b - eating
eye	eye
inviting	invit - ing
prodded	p - rod - d - ed
awarded	award - ed
pretend	pretend
sun-filled	sun-filled
every	ever - y
richness	richness
unconnected	un - connected
exquisitely	exquisitely
hallucination	hallucination
utmost	utmost
accent	accent
catapult	catapult
add	add
nervous	nervous
can	c - an
rouged	roug - ed
incredulity	in - credulity
rouge	rouge
settle	settle
justified	justifi - ed
three-quarters	three-quarters
tracked	track - ed
liable	liable
bundle	bundle
craving	craving
secrets	secret - s
redder	redder
blast	b - last
slightest	s - light - est
rasping	rasp - ing
determine	determin - e
axiom	axiom
pupil	pupil
resists	resist - s
criticism	criticism
shone	s - h - one
deliberately	deliberate - ly
insults	insult - s
joined	join - ed
traps	traps
donkey	donkey
humblest	humbl - est
single	s - ingl - e
opinion	opinion
page	p - age
crumbly	crumbl - y
nearby	nearby
reprinted	re - print - ed
sounded	sound - ed
inheritance	inherit - ance
importance	importance
underground	under - ground
genially	genially
decanter	decanter
fists	fist - s
ignored	ignor - ed
shares	share - s
reluctantly	reluctantly
robbing	robb - ing
melt	melt
reflected	reflect - ed
incorrectly	in - correctly
shoe	shoe
awkwardly	awkward - ly
over	over
queer	queer
re-read	re- - read
restless	restles - s
trials	trial - s
1914	1914
bazaars	bazaar - s
case	case
ground	ground
barefoot	barefoot
rebelled	re - bell - ed
war	war
clasped	clasp - ed
victoriously	victoriously
swarmed	s - warm - ed
litre	litre
strongly	strong - ly
waters	water - s
codewords	codeword - s
china	c - hina
overthrow	overthrow
ministry	ministry
horrible	horribl - e
subtler	subtl - er
sentimentally	sentiment - ally
bits	bit - s
abuse	abus - e
reprisals	reprisal - s
furious	furious
uncomprehending	un - comprehend - ing
zoom	zoom
murdered	murder - ed
subsequent	s - ubsequent
whispered	whisper - ed
streamed	stream - ed
persia	persia
stops	s - top - s
threshold	threshold
anything	anyth - ing
determining	determin - ing
pigeon	pigeon
bookshelves	bookshelves
healthy	health - y
when	w - h - en
strategy	strategy
winston	winston
unintelligible	un - intelligible
shaftesbury	shaftesbur - y
hit	h - it
semi-divine	semi-divine
dictionary	dictionary
coined	coin - ed
corrected	correct - e - d
features	feature - s
irregular	irregular
ache	ach - e
stationer	station - er
whining	whin - ing
ghosts	ghost - s
its	its
irregularities	irregular - ities
properly	proper - ly
rook	rook
literary	literary
cheated	c - heat - ed
obeisance	obeis - ance
factor	factor
hierarchical	hierarchical
misprints	misprint - s
provided	provide - d
postpone	postpone
negroes	negroes
strident	strident
negroid	negroid
store	stor - e
lucid	lucid
us	us
tramp	tramp
deadlier	deadlier
pricked	prick - ed
full	full
twig-littered	twig-littered
.	.
courtesy	courtesy
plank	p - lank
sagging	sagging
whiteness	whitene - s - s
tinged	ting - ed
evicted	evict - ed
longhoped-for	longhoped-for
preparations	preparation - s
singly	sing - ly
taste	taste
testing	test - ing
pool	p - ool
drum	drum
fourteen	fourteen
bearer	bear - er
toothy	tooth - y
washing	wash - ing
confessing	confess - ing
spots	spot - s
quasi-instinctive	quasi-instinctive
stage	s - t - age
rang	rang
purpose	purpose
starting-point	s - tarting-point
certain	certain
founded	found - ed
hypocrites	hypocrite - s
curses	curses
provinces	province - s
scrimmage	scrimmage
reception	recept - ion
fuss	fus - s
annihilating	annihilat - ing
gate	gate
insane	in - sane
reshape	re - shape
estimates	estimate - s
intelligent	in - telligent
soldier	soldier
fretfully	fretfully
chestnut	chestnut
appreciation	appreciat - ion
delightedly	delight - ed - ly
heavier	heavi - er
pleasures	pleasure - s
cluster	c - lust - er
tip	tip
breadcrusts	breadcrust - s
alert	alert
reflect	reflect
useless	useless
resettling	resettl - ing
rulership	rulership
engaging	engag - ing
governments	govern - ment - s
mystically	mystical - ly
venomous	venomou - s
rectified	rectifi - ed
statistical	statistic - al
scenery	scenery
bolts	bolt - s
drugs	drugs
across	a - cross
fling	fling
oppression	oppress - ion
sang	s - ang
agonizing	agonizing
gracefully	grace - ful - ly
man-eaters	man-eater - s
arts	art - s
mentally	mental - ly
beginnings	beginn - ing - s
relief	relief
submission	s - ubmission
understanding	understand - ing
baize	baize
casualties	casualties
filth	filth
fortunately	fortunately
friendly	friend - ly
helped	help - ed
literature	literature
dealt	dealt
pasting	past - ing
conquests	conquest - s
disregarded	disregard - ed
know	know
humility	humility
mistakes	mistake - s
passionately	passionate - ly
pinkish	pinkish
producing	produc - ing
pardon	pardon
pay	pay
day-to-day	day-to-day
profound	pro - found
regenerate	re - generate
loves	love - s
spot	spot
supplemented	supplement - ed
wide-open	wide-open
extorted	extorted
anti-sex	anti-sex
fact	f - act
posted	post - ed
scream	scream
inferiority	inferior - ity
spit	spit
tucked	tuck - ed
sent	sent
dispensed	dispens - ed
boyhood	boyhood
embellishing	embellishing
fundamental	fundamental
hurriedly	hurried - ly
immovably	immovably
necessity	necessit - y
ossified	ossifi - ed
alcohol	alcohol
delightful	delight - ful
sawing	sawing
stories	stor - ies
medical	medical
difference	difference
enlightenment	enlighten - ment
eyelids	eyelids
imitation	imitat - ion
vindicate	vindicate
locked	lock - ed
neckerchief	neckerchief
soft	soft
hinges	hinges
banged	banged
cheekbones	cheekbone - s
reject	reject
hard	hard
tough-looking	t - ough-look - ing
hating	hating
leave	leave
needed	need - ed
death-worship	death-worship
invertebrate	invertebrate
graduate	graduat - e
conversion	con - version
frowsy	frowsy
prints	print - s
teachers	teach - er - s
wireless	w - ireless
communists	communist - s
manipulated	manipulate - d
indicated	indicat - ed
predominated	p - re - dominat - ed
improper	im - proper
cancel	cancel
inquisition	inquisit - ion
shorts	short - s
forward	forward
charrington	charrington
cooked	cook - ed
sleeves	s - leev - e - s
talks	talk - s
upsub	upsub
diaphragm	diaphragm
'yenas	'yenas
depths	depth - s
build	build
well-packed	well-packed
membership	member - s - hip
disciplined	discipline - d
perish	perish
neat	neat
definite	definite
hand-grenade	hand-grenad - e
poisons	poison - s
force	forc - e
carelessness	careless - ness
downhearted	downhearted
stormed	storm - ed
new	new
feelings	feel - ing - s
had	ha - d
forbearance	forbearance
contortions	contort - ion - s
persuading	persuad - ing
tell	t - ell
we	we
borrowed	borrow - ed
privations	privation - s
promise	promis - e
'opeless	'opele - s - s
tenses	tens - e - s
dark-red	dark-red
silky	s - ilky
world	world
oligarchy	oligarch - y
near	near
collectivism	collectivism
doctrines	doctrine - s
project	project
convulsion	convuls - ion
below	be - low
rallies	ralli - e - s
thundering	thunder - ing
recovery	re - cover - y
lost	l - ost
thinked	think - ed
snowdrift	snowdrift
arose	a - rose
painful	painful
widened	wid - en - ed
wainscoting	w - ainscot - ing
reg'lar	re - g'lar
barking	bark - ing
continually	continu - ally
advantage	advantage
candle	candle
occasions	occasion - s
rubbish	rubbish
seventy	s - event - y
skeleton	skeleton
half	half
mans	mans
unbroken	un - broken
baulks	baulks
stimulus	stimulu - s
woods	wood - s
quadrilateral	quadrilateral
decide	decid - e
displayed	dis - play - ed
avoiding	avoid - ing
baldly	bald - ly
cattle	cattle
folded	fold - ed
forties	forties
needing	need - ing
overt	overt
hovered	h - over - ed
truths	truth - s
cherished	cherish - ed
uneasiness	un - easiness
villages	village - s
keepsake	keepsake
begetting	be - getting
boot	boot
affixes	affix - e - s
dragged	dragg - ed
inscribed	inscribed
bellowed	b - ellowed
copies	copi - e - s
judged	judg - ed
translation	translat - ion
repainted	re - paint - ed
travelled	travelled
cyclical	cyclical
quite	quit - e
developing	develop - ing
adherents	adherent - s
shedding	s - hedd - ing
unendurable	un - endur - able
hazel	hazel
surrender	surrender
coincide	coincid - e
fiercely	fierce - ly
horizon	horizon
supple	supple
warmer	warm - er
total	total
covers	cover - s
backyard	b - ackyard
eaten	eat - en
herself	her - self
nonsmoker	nonsmoker
exile	exile
renewal	re - new - al
evenings	even - ing - s
kissed	kiss - ed
utterance	utter - ance
better	better
mahogany	mahogany
hauling	hauling
whereabouts	w - hereabouts
decay	decay
despise	despis - e
grille	grille
heels	heel - s
catechism	catechism
nation	nation
background	back - ground
ceased	ceas - ed
rabbit-cropped	rabbit-cropped
momentary	moment - ary
dares	dare - s
chronic	chronic
first-rate	first-rate
friendships	friendship - s
slits	s - lit - s
hiking	hiking
risen	rise - n
untruthfully	un - truthful - ly
top	top
unaware	un - aware
clicked	click - ed
emaciation	emaciation
toiling	toil - ing
fought	f - ought
divined	divined
subdued	subdued
bombed	bomb - ed
post	post
sprang	s - p - rang
centre	centre
visualized	visualiz - ed
transmit	transmit
clang	clang
paces	pace - s
;	;
non-existent	non-existent
mastered	master - ed
continued	continu - ed
joining	join - ing
ordered	order - ed
ours	our - s
saboteurs	saboteurs
sack	sack
staggering	s - tagger - ing
control	control
disagreeable	dis - agree - able
vigour	vigour
showing	show - ing
piece	piece
ma	ma
march	march
'ere	'er - e
tinking	tinking
results	result - s
several	s - ever - al
depended	depend - ed
bubble	bubble
culpable	culpable
frantic	frantic
occur	occur
priests	p - riest - s
decorated	decorat - ed
joycamp	joycamp
relaxations	relaxation - s
sobbed	sobbed
screwed-up	s - crewed-up
both	b - oth
cloudless	c - loudles - s
minitrue	minitrue
petty	petty
workshop	workshop
agent	a - gent
undirected	un - direct - ed
ignorant	ignorant
remembers	remember - s
exercising	exercis - ing
tread	t - read
relating	relat - ing
yells	yell - s
alarmed	alarmed
ideological	ideological
thought	thought
implied	impli - ed
loathed	loath - ed
white-jacketed	white-jacketed
stuffy	stuff - y
coils	c - oil - s
fool	f - ool
tear	t - ear
tom-toms	tom-tom - s
entertainment	entertain - ment
b	b
dug	dug
joy	joy
sunburnt	s - un - burnt
well-nigh	well-nigh
fossil	fossil
head	head
dome	d - ome
fixed	fix - ed
sets	set - s
swallow	swallow
heretical	heretic - al
creases	creas - e - s
intimates	intimate - s
expanded	expanded
chopper	chopper
burnt	burnt
1983	1983
blocked	b - lock - ed
enlightened	enlighten - ed
echoed	echo - ed
leaked	leak - ed
hurriedly-whispered	hurriedly-whispered
hostility	hostility
impression	impress - ion
entry	en - try
acceptable	accept - able
graceful	grace - ful
interrogated	interrogat - ed
numbering	number - ing
speckled	speckled
presented	present - ed
imitating	imitat - ing
incredibly	incredib - ly
pattern	pattern
exhausting	exhaust - ing
rises	rise - s
deepest	deep - est
abreast	a - breast
sailing-ship	sailing-ship
aberrations	aberrations
obliteration	obliterat - ion
weeds	weeds
caused	cause - d
shrill	s - hrill
thoughtless	thought - less
legible	legible
rubble	rubble
equation	equat - ion
mysticism	mysticism
nine	nine
highly-paid	highly-paid
causing	causing
despotisms	despotism - s
three-sided	three-sided
games	game - s
meal	meal
acceptance	accept - ance
nightly	night - ly
teleprogrammes	teleprogramme - s
edition	edition
frontier	frontier
avoid	avoid
scribbling	scribbl - ing
self-abasement	self- - abasement
thus	thus
distribute	distribut - e
end	end
quiver	quiver
rays	ray - s
unfamiliar	un - familiar
pillowed	pillow - ed
dollars	dollar - s
luckily	luckily
philologist	philologist
valiant	valiant
account	account
ray	ray
willing	willing
check	check
heresies	here - s - ies
formality	formality
slogans	slogan - s
dented	d - ent - ed
rockets	rocket - s
inconceivably	in - conceivably
perception	percept - ion
supposing	suppos - ing
well	well
afflicted	afflicte - d
style	style
motionless	motion - less
banding	band - ing
displacing	dis - plac - ing
prelude	prelude
warfare	warfare
aren't	aren't
shying	shying
weeping	weep - ing
lesson	lesson
grenade	grenade
posterior	posterior
ago	a - go
assert	assert
attempting	attempt - ing
brighter	b - right - er
brother	brother
dose	do - s - e
pope	pope
quacking	quack - ing
sight	sigh - t
'd	'd
suggest	suggest
thrust	thrust
failure	failure
particular	particular
to	to
tripped	t - ripped
ice-cap	ice-cap
caf	caf
clandestinely	clandestine - ly
arithmetic	arithmetic
bearded	beard - ed
majority	majority
wheeled	wheel - ed
elbow	elbow
doubleplus	doubleplus
now-existing	now-exist - ing
rolled	roll - ed
june	jun - e
wrong	wrong
undark	un - dark
cubs	cubs
stem	stem
thought-criminals	thought-criminal - s
astonishing	astonish - ing
whizzing	whizz - ing
literally	literal - ly
bewilderment	bewilderment
furtive	furtive
content	content
euphony	euphony
cascaded	cascad - ed
writhing	writh - ing
what	w - hat
athletic	athletic
cheating	c - h - eating
keen	keen
wandering	wander - ing
particularly	particular - ly
160	160
shouting	shout - ing
deranged	derang - ed
incompetence	in - compet - ence
conspiracies	conspiracie - s
organizations	organiz - ation - s
tendency	tendenc - y
hardened	hard - en - ed
reverse	rever - s - e
mildly	mild - ly
neckerchiefs	neckerchief - s
erases	erase - s
reverting	revert - ing
blinding	blind - ing
long-dead	long-dead
talent	talent
1944	1944
afternoon	afternoon
goodthink	goodthink
hoping	hoping
squad	squad
squeaking	squeak - ing
undertaken	undertaken
cake	c - ake
am	am
furnaces	furnaces
keeping	keep - ing
smith	smith
astray	astray
phrase	phrase
softer	soft - er
underheated	un - derheat - ed
worry	worry
blood	blood
famous	famous
magnitude	magnitude
cabbage-stalk	cabbage-stalk
thigh-bones	thigh-bone - s
hint	hint
creator	creat - or
walked	walk - ed
mother	mother
hairy	hair - y
hook-nosed	hook-nos - ed
address	address
recreations	recreation - s
thirty-six	thirty-six
majesty	majesty
wields	wield - s
pressure	pressure
around	a - round
gooder	good - er
grown	grow - n
driving	driv - ing
cramp	cramp
plusfull	p - lusfull
wives	wives
literate	literate
malleable	malleable
air	a - ir
handleless	handle - less
shins	shin - s
gasps	gasp - s
irrelevant	ir - relevant
comparing	compar - ing
limited	limit - ed
movable	movable
pausing	paus - ing
agents	a - gent - s
society	societ - y
cheerful	cheer - ful
fragments	fragment - s
counter	count - er
throw	throw
youngish	young - ish
tempted	tempt - ed
forcible	forcible
deriving	deriv - ing
round	round
dived	dived
grumbled	grumbled
intimate	intimate
brim	b - rim
twenty-thirty	twenty-thirty
term	term
allows	allow - s
fury	fur - y
heard	hear - d
grating	grating
re-focused	re-focused
temptation	temptation
boiling	boil - ing
visible	visible
fields	field - s
slowed	s - low - ed
beings	being - s
exterminate	exterminat - e
weather	weather
bushes	bushe - s
highest	high - est
gestures	gesture - s
posterity	post - er - ity
trivial	trivial
lighthouse	lighthous - e
crying	crying
love	love
unthinkable	un - thinkable
language	language
output	output
nuzzled	nuzzled
plurals	plurals
list	list
intense	intense
mutters	m - utter - s
so-called	so-called
shock	shock
fraternity	fraternit - y
honesty	honest - y
impulse	impulse
govern	govern
novel-writing	novel-writ - ing
hen	hen
scrabbling	s - crabbl - ing
repelled	re - p - ell - ed
goodthinkful	goodthink - ful
slaughters	s - laughter - s
barber	barber
date	date
paradise	paradis - e
saving	s - aving
silly-faced	silly-faced
worn	worn
emptiness	empti - ness
stumping	stump - ing
trade	trade
model	model
chased	chas - ed
presumably	presumably
bare	bare
cold-faced	cold-faced
didn't	didn't
right-hand	right-hand
ringing	ring - ing
advocated	advocat - ed
fade	fad - e
connected	connected
who	who
prematurely	premature - ly
speciality	special - ity
doubled	doubl - ed
conversational	conversation - al
procreation	pro - creat - ion
1945	1945
confessed	confess - ed
haranguing	harangu - ing
painfully	painful - ly
spent	s - p - ent
wallowing	w - allow - ing
orthodoxy	orthodox - y
setting	sett - ing
darkest	dark - est
somewhere	somewhere
writings	writing - s
equator	equat - or
forty	forty
soldiers	soldier - s
cannot	c - annot
inflexions	inflexion - s
chinese	chinese
essence	essence
certainly	certain - ly
here	here
aureole	aureole
five-and-thirty	five-and-thirty
aching	aching
mechanization	mechaniz - ation
crystal	crystal
overwhelmed	overwhelm - ed
unrolling	un - roll - ing
work	work
pass	pass
rose	rose
kindred	kindred
liberty	liberty
an'	an'
chemist	chemist
familiarize	familiar - ize
items	item - s
meaningless	meaningless
fanatically	fanatic - ally
varied	vari - ed
wading	w - ading
lovely	lovely
regard	regard
published	publish - ed
remove	re - move
stayed	stay - ed
dimmest	dimm - est
indiscretion	in - discretion
spirit	spirit
turmoil	t - urmoil
luck	luck
unresisting	un - resist - ing
fate	fate
holiday	holiday
leader-worship	leader-worship
impalement	impalement
tinny	t - inny
movement	movement
things	thing - s
embraces	embrac - e - s
independent	in - dependent
nineteenth-century	nineteenth-centur - y
pang	pang
scattered	s - cattered
theirs	t - heir - s
murmur	murmur
pages	p - age - s
ampleforth	ampleforth
judge	judg - e
rearrange	re - arrange
rode	rod - e
dimensions	dimension - s
spurts	spurt - s
bread	b - read
bruised	bruis - ed
farthing	farthing
chain	chain
immobile	im - mobile
shooting	shoot - ing
your	your
succeed	succeed
'ow	'ow
noticeable	notice - able
fish	fish
bone	b - one
paralysed	paralys - ed
saucepan	saucepan
carpeted	carpet - ed
pursuit	pursuit
treatise	treatis - e
reintegration	re - integr - ation
such-like	s - uch-lik - e
some	s - ome
decade	decade
voicing	voic - ing
disgust	disgust
overalls	overalls
house	house
means	mean - s
bathroom	bathroom
echoes	echoe - s
body	body
clock	c - lock
laughing	laugh - ing
smoothed	smooth - ed
textbook	textbook
stable	stable
last	last
success	success
nights	night - s
chosen	chosen
state	s - t - at - e
lanes	lane - s
possessions	possession - s
bases	base - s
lot	lot
angle	a - ngle
glad	glad
reveries	reverie - s
ideas	idea - s
facial	facial
nicknames	nickname - s
slaughter	s - laughter
spongy	spongy
biggest	biggest
compliment	compliment
reach	reach
lucky	luck - y
best	b - est
dead	dead
signed	sign - e - d
marriage	marriage
carrying	carry - ing
grow	grow
foolish	foolish
embedded	embedded
adultery	adulter - y
lifeboat	lifeboat
column	column
chewed	chewed
hungry	hungr - y
fluctuate	fluctuat - e
chin	c - hin
jacket	jacket
motion	motion
fretted	fretted
martyrs	martyrs
noises	noise - s
fiction	fict - ion
powdery	powdery
saloon	saloon
flowing	flow - ing
advances	advanc - e - s
brushed	b - rush - ed
colour	colour
doubleplusungood	doubleplusungood
gambolling	gamboll - ing
grimy	grim - y
constituted	con - stituted
communication	communicat - ion
her	her
tremor	tremor
favouritism	favourit - ism
proud	proud
engraving	en - grav - ing
jelly	jelly
identifiable	identifi - able
light-years	light-years
barefooted	barefoot - ed
spurious	spurious
pause	paus - e
same	s - ame
delude	delu - d - e
leather-covered	leather-covered
evil-smelling	evil-smell - ing
rough	rough
accomplices	a - ccomplice - s
stale	s - tale
criminal	criminal
metal-topped	metal-topp - ed
worthy	worth - y
illustrating	illustrat - ing
comfort	comfort
tarnished	tarnished
unit	unit
disgrace	dis - grace
wriggle	wriggl - e
people	people
four	four
brains	b - rain - s
orator	orator
unorthodoxy	un - orthodox - y
projectiles	projectiles
got	go - t
speaker	speak - er
newspapers	newspaper - s
tormentor	torment - or
unreal	un - real
falsifying	falsify - ing
spilt	s - pilt
separation	separat - ion
earliest	earli - est
calculations	calculat - ion - s
clasp	clasp
inspired	inspir - ed
projects	project - s
disappearing	dis - appear - ing
safe	safe
grandmother	grand - mother
later	later
fall	fall
solves	solve - s
impatient	im - patient
summons	summon - s
inefficiently	in - efficient - ly
misprinted	misprint - ed
unexpected	un - expect - ed
tense	tens - e
compendium	compendium
needs	need - s
unproceed	un - proceed
separately	separat - e - ly
trying	trying
scarlet-draped	scarlet-draped
britain	britain
injury	injur - y
appealing	appeal - ing
books	book - s
zeal	zeal
plaster	plaster
receiving	receiv - ing
filthily	filthi - ly
morale	moral - e
reading	re - ading
associations	association - s
difficulty	difficult - y
toe	toe
dark-chinned	dark-chinn - ed
caesar	caesar
bloodthirsty	bloodthirsty
drugged	d - rugged
embezzlement	embezzlement
failing	fail - ing
persecutors	persecut - or - s
shade	shade
passionate	passionate
stickiness	s - ticki - ness
volume	volume
indefatigable	indefatigabl - e
old	old
pieces	piece - s
spaciousness	s - paciousness
carry	carry
takes	take - s
meetings	meet - ing - s
all-important	all-important
opposition	opposit - ion
dribbled	dribbl - ed
hordes	horde - s
knew	knew
paragraph	paragraph
represent	re - present
sideways	sideways
vile	vile
wearing	wear - ing
blot	b - lot
lords	lord - s
treetops	t - reetop - s
spotted	s - pott - ed
edge	edge
knee	knee
advantages	advantage - s
haricot	haricot
hundreds	hundred - s
regimentation	regiment - ation
java	java
predicted	predict - ed
guilt	guilt
situations	situation - s
speed	speed
stations	station - s
child	child
theory	theor - y
tribe	t - rib - e
truly	t - rul - y
unexplored	un - explore - d
hated	hat - ed
yours	your - s
-	-
wax	wax
anew	a - new
ones	one - s
prevent	prevent
self-possession	self- - possess - ion
grass-grown	grass-grown
need	need
pornography	pornography
adverb	adverb
neo-bolshevism	neo-bolshevism
whistle	whistl - e
beginning	beginn - ing
distinctly	distinct - ly
enterprise	enterprise
catholics	catholic - s
gabble	gabbl - e
unrolled	un - roll - ed
twentyfour	t - wentyfour
corridors	corridor - s
bade	bad - e
skull-faced	s - kull-faced
bowed	bowed
prominent	prominent
sex	sex
therapy	therapy
collated	collat - ed
steeple	steeple
timorously	timorous - ly
violated	violate - d
recalled	re - call - ed
ermine	ermin - e
perfect	perfect
waist	waist
childhood	child - hood
flickering	flicker - ing
continues	continu - e - s
horn	horn
spend	spend
anemone	anemone
concertina-like	concertina-like
distinguishable	distinguish - able
fluid	fluid
prevented	prevent - ed
partial	partial
willows	willow - s
full-sized	f - ull-sized
greenish	green - ish
aiming	aiming
airfield	airfield
achieving	achiev - ing
asiatic	asiatic
biologists	biologist - s
fifty-seven	fifty-seven
pipes	pipe - s
rounder	ro - under
proliferated	proliferated
criminals	criminal - s
places	plac - e - s
smash	smash
lay-figure	lay-figure
nostrils	nostrils
revealing	reveal - ing
precise-looking	precise-look - ing
absent-minded	absent-min - d - ed
dodge	dodge
fond	fond
whiffs	whiff - s
earth	ear - th
graves	grave - s
ruffians	ruffians
infected	infect - ed
falsity	falsity
joyless	joyle - s - s
not	not
nothing	nothing
exercises	exercis - e - s
doorway	doorway
floating	float - ing
shortage	shortage
fellow-employee	f - ellow-employee
streak	streak
something	someth - ing
sunday	s - un - day
hurtling	hurtling
sye	s - ye
continuously	c - ontinuous - ly
relative	relat - ive
or	or
tortures	torture - s
board	board
badness	b - adness
hadn't	hadn't
embarrassment	embarrass - ment
goodthinkwise	goodthink - wise
winked	w - ink - ed
soundless	soundless
laborious	laborious
series	s - erie - s
contrary	contrary
wooden	wood - en
enthusiasm	enthusiasm
touched	touch - ed
cliff	c - liff
airstrip	airstrip
undigested	undigested
compromise	compromis - e
wearily	weari - ly
scaly	scaly
fulminating	fulminat - ing
neither	n - either
extension	extension
pyramids	pyramid - s
shocking	shock - ing
tower	tower
abruptly	abrupt - ly
available	available
choked	chok - ed
crimestop	crimestop
leaves	leave - s
siberia	s - iberia
mournfully	mournful - ly
defection	defect - ion
constructed	construct - ed
helicopter	helicopter
alteration	alteration
spirals	spiral - s
stair	stair
batteries	batter - ies
cases	case - s
covered	cover - ed
dizzy	dizzy
fuller	fuller
improvising	improvis - ing
none	n - one
politicals	political - s
accuracy	accuracy
reality	re - ality
sustain	sustain
wondering	wonder - ing
adjectival	adjectiv - al
bitterness	bitter - ness
entanglements	entanglements
redivision	redivision
trailing	t - rail - ing
solved	solved
homeless	homeless
dental	d - ent - al
scorched	scorch - ed
tracks	track - s
dappled	dappled
connotation	connot - ation
part-time	part-tim - e
loitering	loitering
glittering	glitter - ing
st	st
trampling	trampl - ing
sensitivity	sensitivity
mines	mine - s
thickened	thick - en - ed
rippled	rippl - ed
soothing	sooth - ing
peelings	peeling - s
evening	even - ing
violate	violate
copy	copy
lying	lying
wailed	wail - ed
shows	show - s
demand	demand
leather	leather
fifty-five	fifty-f - ive
milkless	milkles - s
entertained	entertain - ed
irony	irony
luxuries	luxuries
rock	rock
undermine	undermine
leap	leap
surprised	s - urpris - ed
outburst	out - burst
silently	silent - ly
occasion	occasion
1968	1968
space	s - pace
faces	face - s
stolen	stolen
standing	stand - ing
despised	despis - ed
broader	broad - er
hopped	hopp - ed
luxuriously	luxuriously
filling	fill - ing
instructions	instruction - s
interrupted	interrupted
unformed	un - form - ed
rot	rot
unconsciousness	un - consciou - s - ness
unexampled	un - example - d
landscape	landscap - e
triumphant	triumphant
fly	fly
drunks	drunk - s
fourteen-thirty	fourteen - -thirty
infer	in - fer
broad-chested	broad-chested
transfer	transfer
blubbering	blubber - ing
foreign	foreign
spraying	spray - ing
voluptuously	voluptuous - ly
sworn	s - w - orn
section	sect - ion
railway	railway
goldstein	goldstein
renegade	renegade
reopen	re - open
towered	tower - ed
heresy	here - s - y
subjected	subject - ed
thinkers	think - er - s
iron	iron
famine	f - a - mine
hunger	hung - er
examine	examin - e
'a	'a
interrogation	interrogat - ion
stagnate	stagnate
wiping-out	wiping-out
forth	f - orth
fashion	fash - ion
fancy	fancy
bottom	bottom
lavatories	lavator - ies
beaten	b - eat - en
unlight	un - light
amends	amend - s
bluebottle	bluebottle
colours	colour - s
loss	los - s
peoples	people - s
induced	induce - d
league	league
cooking-pots	cooking-pots
simultaneously	s - imultaneous - ly
pierced	pierc - ed
itching	itching
refuted	refuted
somebody	somebody
treaties	treat - ies
dusted	dust - ed
spoils	spoils
authentically	authentically
licked	licked
doubtfully	doubt - ful - ly
fifth	fifth
governed	govern - ed
stool	s - t - ool
unborn	un - born
all-powerful	all-powerful
sunlit	s - un - lit
code	code
learned	learn - ed
cross-referencing	cross-referencing
recurring	recurr - ing
shuddered	shudder - ed
square	s - quare
slatternly	slatternly
funds	fund - s
matters	matter - s
tooth	tooth
adulteries	adulter - ies
bite	bit - e
driveling	driveling
integrity	integr - ity
plainly	plain - ly
trained	t - rain - ed
embodiment	embodi - ment
war-fever	war-fever
bloom	bloom
existed	exist - ed
including	includ - ing
peeped	peeped
speculatively	speculative - ly
conscious	consciou - s
fearless	fear - les - s
inform	in - form
weighed	weighed
frontiers	frontier - s
embodied	embodi - ed
succession	success - ion
soil	s - oil
amersham	amersham
ethical	ethic - al
predicament	p - redicament
economies	economies
swished	s - wish - ed
bounced	bounc - ed
skeleton-like	skeleton - -like
presently	present - ly
genuinely	genuine - ly
crown	c - rown
heritage	heritage
nosing	nosing
voluntarily	voluntarily
chicken-houses	chicken-house - s
grows	grow - s
spray	spray
confident	c - onfident
small	small
tank	tank
proclaimed	proclaim - ed
germany	german - y
noisy	noisy
tom	tom
minimum	minimum
street	street
thigh	t - high
invention	invent - ion
dispersed	dispersed
impoverishment	impoverishment
describing	describ - ing
grouped	group - ed
kids	kid - s
prejudice	prejudice
narrow	narrow
april	april
deceived	deceiv - ed
vegetable	vegetable
erased	erase - d
theoretical	theoretical
so	so
pretext	pretext
repaired	re - pair - ed
seaborne	s - eaborne
unpunished	un - punish - ed
jointly	joint - ly
unwholesome	unwholesom - e
awkward	awkward
part	part
waxworks	waxwork - s
penetrated	penetrat - ed
tone	t - one
batter	batter
motor	motor
measures	measur - e - s
possibility	possibilit - y
encounter	encounter
isn't	isn't
nonsense	nonsense
branches	branch - e - s
faintest	faint - est
religion	religion
disentangled	dis - entangl - ed
squirmed	squirmed
explained	explain - ed
hidden	hidden
bold-looking	bold-looking
speeches	speech - e - s
wound	wound
say	say
wonder	wonder
rejected	reject - ed
beg	beg
bowels	bowels
yell	yell
teacup	teacup
politicians	politicians
crime	crime
necessary	necessary
metres	metre - s
saucepans	saucepan - s
inimical	inimical
spoonfuls	s - poonfuls
faced	face - d
darning	darn - ing
tiddly-winks	tiddly-winks
ruin	ruin
zipper	zipper
obscene	obscen - e
picture-frames	picture-frames
observers	observers
sweat	sweat
material	material
haven't	haven't
scientists	scientist - s
everything	everyth - ing
mysteriously	mysterious - ly
their	t - heir
kiss	kiss
threaten	threaten
ferocity	ferocity
bombs	bomb - s
statistics	statistic - s
squeak	squeak
bookcase	bookcas - e
cubicles	cubicle - s
ashes	a - s - he - s
correct	correct
portrait	portrait
constructionwise	construction - wise
rarity	rarity
perverse	pervers - e
defiler	defiler
weak	weak
vapour	vapour
evaporate	evaporate
doublethink	doublethink
expressing	express - ing
exchange	exchange
boat	boat
prophecies	prophecies
openly	open - ly
indifference	in - difference
solipsism	solipsism
imprisonment	imprisonment
violent	violent
enforcing	en - forc - ing
ethics	ethic - s
trickling	trickl - ing
starved	starv - ed
basin	basin
written	written
summon	summon
truthfulness	truthful - ness
half-apprehensive	half-apprehensive
broke	brok - e
clamorous	clamorou - s
night	night
aged	age - d
forsook	forsook
briskly	b - risk - ly
wordless	wordles - s
i	i
battles	battle - s
neutralize	neutralize
pelting	pelting
specialized	special - ized
position	position
adjective	adjectiv - e
adoption	adopt - ion
curvature	curvature
oil	oil
rodent	rodent
wanted	want - ed
stopping	stopp - ing
zealous	zealous
remedied	re - medi - ed
untrue	un - true
interested	interest - ed
training	train - ing
patriotic	patriotic
enlist	enlist
fabulous	fabulous
foreshortening	fore - shorten - ing
neurotically	neurotically
rumours	rumour - s
intercourse	inter - course
contradiction	contradict - ion
social	social
annual	annual
department	department
wrists	wrist - s
metre	metre
honestly	honest - ly
imperturbable	im - perturb - able
reasonably	reason - ably
sententiously	sententious - ly
unreproved	un - re - prov - ed
consent	con - sent
holder	hold - er
bed	bed
arise	a - rise
popular	popular
shouts	shout - s
relevance	relevance
unattended	un - attend - ed
dearie	d - earie
accounted	account - ed
illicit	illicit
theyll	theyll
held	held
trim	t - rim
kept	kept
broken	broken
cracks	crack - s
territory	territor - y
given	give - n
roaring	roar - ing
fresh	fresh
conceivably	conceivably
recurrence	re - currenc - e
signatures	s - ignature - s
uncertain	un - certain
deception	deception
developments	develop - ment - s
safety	safe - t - y
wolfed	wolfed
for	f - or
drained	d - rain - ed
birth	birth
fro	fro
o	o
rob	rob
affection	affect - ion
fastened	fast - en - ed
knows	know - s
proof	p - roof
visiting	visit - ing
porpoise	porpoise
tired-looking	t - ired-looking
buried	buri - ed
anywhere	anywhere
big	big
franca	franca
economy	econom - y
cramped	cramp - ed
discuss	discuss
addressing	address - ing
diminish	diminish
australasia	australasia
'em	'em
repairs	re - pair - s
orthodox	orthodox
returns	re - turn - s
error	error
papier-mch	papier-mch
produced	produc - ed
lyric	lyric
shameless	shameless
announce	announce
situation	situation
struggle	struggl - e
tenements	tenement - s
width	wid - th
swinging	s - wing - ing
have	have
meditations	meditat - ion - s
leisured	leisure - d
liberal	liberal
husband	husband
bombing	bomb - ing
boldly	b - old - ly
penitence	penitence
seem	seem
tenderness	tenderne - s - s
undifferentiated	un - differentiat - ed
departure	departure
increased	in - creas - ed
rout	rout
tale	tale
ficdep	ficdep
puzzled	puzzled
milton	milton
pointed	point - ed
unspoken	un - spoken
lines	line - s
prawn	prawn
listlessness	listlessness
compounded	compound - ed
malquoted	mal - quot - ed
noticeably	notice - ably
traffic	traffic
entering	enter - ing
shakespeare	s - hakespeare
mongolian	mongolia - n
insanity	in - sanity
roof	roof
staff	staff
splitting-off	splitting-off
arm-chair	arm-chair
beneath	beneath
awoke	a - woke
shrank	s - h - rank
scars	s - car - s
emphasis	emphasis
row	row
salaried	s - alaried
yielded	yield - ed
likes	like - s
skull	s - kull
powerful	power - ful
honour	honour
increases	increase - s
cigarettes	cigarette - s
recurrent	re - current
symptoms	symptom - s
individually	individual - ly
symptom	symptom
powdered	powdered
're	're
knock	knock
woman	woman
never-broken	never-broken
agreeing	agree - ing
exerted	exert - ed
flapped	flapp - ed
calmer	calm - er
groans	groan - s
outstanding	out - stand - ing
scrawl	s - crawl
establish	establish
mutually	mutually
formulated	formulate - d
sit	s - it
bedhead	bedhead
deafening	deafening
dont	dont
lamplight	lamplight
slummy	slummy
millimetre	millimetre
special	special
wheels	wheel - s
define	defin - e
torrent	torrent
whipped	whipp - ed
pour	pour
catholic	catholic
definitive	definitive
followers	follow - er - s
dependent	dependent
twisted	twist - ed
pencil	pencil
bladder	b - ladder
chalk	chalk
purely	pure - ly
foreigner	foreign - er
scrape	scrap - e
courts	court - s
admirer	admirer
digression	digression
fits	f - it - s
whereas	whereas
resisting	resist - ing
hovering	h - over - ing
'ome	'ome
halves	halve - s
banners	banner - s
doubting	doubt - ing
girls	girl - s
'ear	'ear
cubes	cube - s
socks	s - ock - s
flats	flat - s
invincible	invincible
says	say - s
eating	eating
titles	title - s
today	today
hullo	hullo
dragging	dragg - ing
humiliation	humiliat - ion
defining	defin - ing
divided	divid - ed
back-street	back-street
medley	medley
preoccupy	p - re - occupy
trust	trust
groan	groan
sub-machine	sub-machine
suddenly	sudden - ly
pain	pain
knowledge	knowledge
weariness	weari - ness
becoming	be - coming
themes	them - e - s
evidently	evident - ly
community	commun - ity
memorized	memoriz - ed
lean	lean
sea	s - ea
exhaustive	exhaust - ive
solely	sole - ly
censored	censor - ed
elimination	eliminat - ion
voices	voice - s
kilometres	kilometre - s
placed	plac - ed
interchange	inter - change
euphemisms	euphemism - s
frozen	froze - n
uttering	utter - ing
thundered	thunder - ed
nineteen-forties	nineteen-forties
till	t - ill
tricky	trick - y
sexes	sex - e - s
doctor	doctor
outfit	outfit
burn	burn
shuffling	shuffl - ing
rails	rail - s
warning	warn - ing
invariable	invariabl - e
box	box
imposed	impos - ed
iniquity	iniquit - y
patrols	patrol - s
nex'	nex'
nobility	nobility
shutting	shut - t - ing
drama	drama
derided	derided
'll	'll
machine-gun	machine-gun
seamed	s - eamed
executed	execut - ed
attentive	attentive
upstairs	upstair - s
corpse	corpse
